Date,설비용량(MW),공급능력(MW),최대전력(MW),공급예비력(MW),공급예비율(%)
2017-01-01,105866,89861,59234,30627,51.7
2017-01-02,105866,92573,72901,19672,27.0
2017-01-03,105866,94223,75471,18752,24.8
2017-01-04,105866,92353,75778,16575,21.9
2017-01-05,105866,92474,76304,16170,21.2
2017-01-06,105866,92841,74060,18781,25.4
2017-01-07,105866,90470,64879,25591,39.4
2017-01-08,105866,90644,59058,31586,53.5
2017-01-09,105866,92252,75090,17162,22.9
2017-01-10,105866,93039,76690,16349,21.3
2017-01-11,105866,94862,78898,15964,20.2
2017-01-12,105866,94338,78403,15935,20.3
2017-01-13,105866,94912,80079,14833,18.5
2017-01-14,105866,92828,69894,22934,32.8
2017-01-15,105866,91004,66021,24983,37.8
2017-01-16,105866,93313,80790,12523,15.5
2017-01-17,105866,94280,81681,12599,15.4
2017-01-18,106238,95091,79959,15132,18.9
2017-01-19,106238,94146,80171,13975,17.4
2017-01-20,106238,94284,81765,12519,15.3
2017-01-21,106238,90927,71225,19702,27.7
2017-01-22,106238,91965,66749,25216,37.8
2017-01-23,106238,95443,83657,11786,14.1
2017-01-24,106238,96526,82884,13642,16.5
2017-01-25,106238,95823,81686,14137,17.3
2017-01-26,106238,95631,78670,16961,21.6
2017-01-27,106238,91078,62908,28170,44.8
2017-01-28,106238,89072,56442,32630,57.8
2017-01-29,106238,89100,57667,31433,54.5
2017-01-30,106238,91686,62634,29052,46.4
2017-01-31,106238,94937,77034,17903,23.2
2017-02-01,107098,95220,80173,15047,18.8
2017-02-02,107098,96341,80243,16098,20.1
2017-02-03,107098,96289,78232,18057,23.1
2017-02-04,107098,94172,67533,26639,39.4
2017-02-05,107098,94991,62577,32414,51.8
2017-02-06,107098,96366,78251,18115,23.1
2017-02-07,107098,97305,80163,17142,21.4
2017-02-08,107098,96980,79274,17706,22.3
2017-02-09,107098,97002,80002,17000,21.2
2017-02-10,107098,95916,81268,14648,18.0
2017-02-11,107098,92955,69363,23592,34.0
2017-02-12,107098,93782,64047,29735,46.4
2017-02-13,107098,96343,79050,17293,21.9
2017-02-14,107098,96561,78279,18282,23.4
2017-02-15,107098,96403,77770,18633,24.0
2017-02-16,107098,96295,75604,20691,27.4
2017-02-17,107098,96207,74358,21849,29.4
2017-02-18,107098,90042,65574,24468,37.3
2017-02-19,107098,89643,61553,28090,45.6
2017-02-20,107098,93928,76063,17865,23.5
2017-02-21,107098,93347,77149,16198,21.0
2017-02-22,107098,93689,78523,15166,19.3
2017-02-23,107098,93526,75909,17617,23.2
2017-02-24,107098,92732,75970,16762,22.1
2017-02-25,107098,91811,64596,27215,42.1
2017-02-26,107098,91375,60444,30931,51.2
2017-02-27,107098,93171,73564,19607,26.7
2017-02-28,107098,92437,73617,18820,25.6
2017-03-01,107098,92104,64523,27581,42.7
2017-03-02,107098,92979,75921,17058,22.5
2017-03-03,107098,93749,74262,19487,26.2
2017-03-04,107098,91420,62651,28769,45.9
2017-03-05,107098,91770,58780,32990,56.1
2017-03-06,107098,94148,73396,20752,28.3
2017-03-07,107098,93840,76756,17084,22.3
2017-03-08,107703,92902,76634,16268,21.2
2017-03-09,107703,92807,74556,18251,24.5
2017-03-10,107703,92047,73349,18698,25.5
2017-03-11,107703,90228,62468,27760,44.4
2017-03-12,107703,91063,57589,33474,58.1
2017-03-13,107703,93327,70385,22942,32.6
2017-03-14,107703,91119,70674,20445,28.9
2017-03-15,107703,90591,71134,19457,27.4
2017-03-16,107703,91482,70775,20707,29.3
2017-03-17,108601,91839,70322,21517,30.6
2017-03-18,108601,90013,61921,28092,45.4
2017-03-19,108601,87910,56890,31020,54.5
2017-03-20,108601,87922,69809,18113,25.9
2017-03-21,108601,87503,68210,19293,28.3
2017-03-22,108601,87657,70170,17487,24.9
2017-03-23,108601,87672,69549,18123,26.1
2017-03-24,108601,88072,69257,18815,27.2
2017-03-25,108601,86606,61395,25211,41.1
2017-03-26,108601,87877,57467,30410,52.9
2017-03-27,108601,88323,70135,18188,25.9
2017-03-28,109493,86241,70060,16181,23.1
2017-03-29,109493,87117,69891,17226,24.6
2017-03-30,109493,87994,67807,20187,29.8
2017-03-31,109493,88725,68976,19749,28.6
2017-04-01,110502,82935,59219,23716,40.0
2017-04-02,110502,85311,56420,28891,51.2
2017-04-03,110502,84021,65686,18335,27.9
2017-04-04,110502,86064,65973,20091,30.5
2017-04-05,110502,86046,68200,17846,26.2
2017-04-06,110502,87916,69129,18787,27.2
2017-04-07,110502,87253,65396,21857,33.4
2017-04-08,110502,86383,56759,29624,52.2
2017-04-09,110502,84126,54617,29509,54.0
2017-04-10,110502,87013,63993,23020,36.0
2017-04-11,110502,87343,65921,21422,32.5
2017-04-12,110502,85970,64262,21708,33.8
2017-04-13,110502,84544,64430,20114,31.2
2017-04-14,110502,85529,64493,21036,32.6
2017-04-15,110671,83099,55961,27138,48.5
2017-04-16,110671,82735,54282,28453,52.4
2017-04-17,110671,82855,66355,16500,24.9
2017-04-18,110671,83724,65101,18623,28.6
2017-04-19,110671,83051,62985,20066,31.9
2017-04-20,110671,83682,65335,18347,28.1
2017-04-21,110671,84048,63284,20764,32.8
2017-04-22,110671,83523,56424,27099,48.0
2017-04-23,110671,81850,54420,27430,50.4
2017-04-24,110671,82873,63820,19053,29.9
2017-04-25,110671,81209,64533,16676,25.8
2017-04-26,110671,80871,63329,17542,27.7
2017-04-27,110671,79714,63751,15963,25.0
2017-04-28,110671,80659,62861,17798,28.3
2017-04-29,110671,81130,55507,25623,46.2
2017-04-30,110671,80635,54163,26472,48.9
2017-05-01,110671,82501,56790,25711,45.3
2017-05-02,110671,82331,62100,20231,32.6
2017-05-03,110671,82942,58991,23951,40.6
2017-05-04,110671,83056,60366,22690,37.6
2017-05-05,110671,83028,56195,26833,47.7
2017-05-06,110671,79430,53271,26159,49.1
2017-05-07,111168,80272,53449,26823,50.2
2017-05-08,111168,77697,63803,13894,21.8
2017-05-09,111168,79013,61163,17850,29.2
2017-05-10,111168,80821,65137,15684,24.1
2017-05-11,111168,80138,65315,14823,22.7
2017-05-12,111168,80398,66500,13898,20.9
2017-05-13,111168,78407,57892,20515,35.4
2017-05-14,111168,77523,54246,23277,42.9
2017-05-15,111168,81620,64452,17168,26.6
2017-05-16,111168,80844,64434,16410,25.5
2017-05-17,111168,79301,65506,13795,21.1
2017-05-18,111168,80633,66176,14457,21.8
2017-05-19,111168,80693,66619,14074,21.1
2017-05-20,111292,80072,58028,22044,38.0
2017-05-21,111292,81065,55580,25485,45.9
2017-05-22,111292,81274,67482,13792,20.4
2017-05-23,111292,82751,67772,14979,22.1
2017-05-24,111292,83178,67810,15368,22.7
2017-05-25,111292,81835,67007,14828,22.1
2017-05-26,111292,83009,64402,18607,28.9
2017-05-27,111292,81212,56633,24579,43.4
2017-05-28,111292,82527,55277,27250,49.3
2017-05-29,111292,83014,69854,13160,18.8
2017-05-30,111292,82497,69887,12610,18.0
2017-05-31,111292,81665,69234,12431,18.0
2017-06-01,111292,81837,68853,12984,18.9
2017-06-02,111292,82221,65633,16588,25.3
2017-06-03,111292,76968,56898,20070,35.3
2017-06-04,111292,77623,54654,22969,42.0
2017-06-05,111292,81483,65530,15953,24.3
2017-06-06,111292,81083,61087,19996,32.7
2017-06-07,111292,82683,67008,15675,23.4
2017-06-08,111292,81647,66753,14894,22.3
2017-06-09,111292,83707,67241,16466,24.5
2017-06-10,111292,82165,58759,23406,39.8
2017-06-11,111292,83161,55233,27928,50.6
2017-06-12,111292,83421,66895,16526,24.7
2017-06-13,112316,84907,68006,16901,24.9
2017-06-14,112316,85205,68179,17026,25.0
2017-06-15,112316,84747,70246,14501,20.6
2017-06-16,112316,86941,71332,15609,21.9
2017-06-17,112316,83591,61261,22330,36.5
2017-06-18,112316,81885,57785,24100,41.7
2017-06-19,111729,85006,72473,12533,17.3
2017-06-20,111729,85132,73961,11171,15.1
2017-06-21,112779,86441,73408,13033,17.8
2017-06-22,112779,86466,73196,13270,18.1
2017-06-23,112779,86724,75077,11647,15.5
2017-06-24,113705,83428,63296,20132,31.8
2017-06-25,113705,85323,58182,27141,46.6
2017-06-26,113705,87820,73186,14634,20.0
2017-06-27,113705,87531,73199,14332,19.6
2017-06-28,113705,87698,74442,13256,17.8
2017-06-29,113705,87585,74958,12627,16.8
2017-06-30,113705,87888,75413,12475,16.5
2017-07-01,113305,86424,64637,21787,33.7
2017-07-02,113305,87819,61902,25917,41.9
2017-07-03,113305,92113,77051,15062,19.5
2017-07-04,113305,91290,78325,12965,16.6
2017-07-05,113305,89667,78494,11173,14.2
2017-07-06,113305,91939,80673,11266,14.0
2017-07-07,113305,93549,78640,14909,19.0
2017-07-08,113305,89545,68187,21358,31.3
2017-07-09,113305,88021,64400,23621,36.7
2017-07-10,113305,92732,78441,14291,18.2
2017-07-11,113305,92247,79685,12562,15.8
2017-07-12,113305,91477,80087,11390,14.2
2017-07-13,113305,92621,81830,10791,13.2
2017-07-14,113305,93437,83214,10223,12.3
2017-07-15,113305,89847,69532,20315,29.2
2017-07-16,113305,89317,65320,23997,36.7
2017-07-17,113305,93900,81042,12858,15.9
2017-07-18,113351,94706,80451,14255,17.7
2017-07-19,113351,94157,82682,11475,13.9
2017-07-20,113351,94712,84558,10154,12.0
2017-07-21,113351,94987,84586,10401,12.3
2017-07-22,113351,90733,75408,15325,20.3
2017-07-23,113351,89993,68319,21674,31.7
2017-07-24,113351,94461,82052,12409,15.1
2017-07-25,113351,94780,83321,11459,13.8
2017-07-26,113351,95163,80610,14553,18.1
2017-07-27,113351,95140,79180,15960,20.2
2017-07-28,113351,95482,78700,16782,21.3
2017-07-29,113351,90645,66214,24431,36.9
2017-07-30,113351,91077,63971,27106,42.4
2017-07-31,113351,93121,69467,23654,34.1
2017-08-01,113351,93092,71974,21118,29.3
2017-08-02,113351,93550,73103,20447,28.0
2017-08-03,113351,93031,74343,18688,25.1
2017-08-04,113351,91769,76990,14779,19.2
2017-08-05,113351,88265,72300,15965,22.1
2017-08-06,113351,88398,70906,17492,24.7
2017-08-07,113351,95125,84489,10636,12.6
2017-08-08,113351,94804,83775,11029,13.2
2017-08-09,113351,93714,80418,13296,16.5
2017-08-10,113351,94592,79807,14785,18.5
2017-08-11,113351,95564,80629,14935,18.5
2017-08-12,114206,91506,69570,21936,31.5
2017-08-13,114206,90404,61500,28904,47.0
2017-08-14,114206,94832,72855,21977,30.2
2017-08-15,114206,93361,67072,26289,39.2
2017-08-16,114206,95468,75902,19566,25.8
2017-08-17,114206,95799,77288,18511,24.0
2017-08-18,114206,95321,77648,17673,22.8
2017-08-19,114206,93359,67973,25386,37.3
2017-08-20,114206,91390,62497,28893,46.2
2017-08-21,114206,94942,79104,15838,20.0
2017-08-22,114206,94813,80879,13934,17.2
2017-08-23,114206,94851,83840,11011,13.1
2017-08-24,114206,95345,83432,11913,14.3
2017-08-25,114206,94808,79071,15737,19.9
2017-08-26,114206,91577,63547,28030,44.1
2017-08-27,114206,91074,59950,31124,51.9
2017-08-28,114206,95752,75454,20298,26.9
2017-08-29,114206,96582,71234,25348,35.6
2017-08-30,114206,96569,68797,27772,40.4
2017-08-31,114206,95847,70229,25618,36.5
2017-09-01,114206,94100,70931,23169,32.7
2017-09-02,114206,91533,61591,29942,48.6
2017-09-03,114206,91678,58814,32864,55.9
2017-09-04,114206,92846,72688,20158,27.7
2017-09-05,114206,94499,71944,22555,31.4
2017-09-06,114206,95006,71880,23126,32.2
2017-09-07,114206,94511,71699,22812,31.8
2017-09-08,114206,93909,73038,20871,28.6
2017-09-09,114206,89779,64087,25692,40.1
2017-09-10,114206,88745,59509,29236,49.1
2017-09-11,114206,92651,70946,21705,30.6
2017-09-12,114206,92313,72229,20084,27.8
2017-09-13,114206,93014,70373,22641,32.2
2017-09-14,114206,94191,71099,23092,32.5
2017-09-15,114206,92279,69521,22758,32.7
2017-09-16,114206,88214,60602,27612,45.6
2017-09-17,114206,87659,58088,29571,50.9
2017-09-18,114206,92551,71299,21252,29.8
2017-09-19,114206,92665,73115,19550,26.7
2017-09-20,114206,92456,68979,23477,34.0
2017-09-21,114206,91777,69362,22415,32.3
2017-09-22,114206,91816,69987,21829,31.2
2017-09-23,114206,89309,61791,27518,44.5
2017-09-24,114206,89652,59195,30457,51.5
2017-09-25,114206,91820,72798,19022,26.1
2017-09-26,114206,92144,72947,19197,26.3
2017-09-27,114206,90947,70978,19969,28.1
2017-09-28,114206,91397,68330,23067,33.8
2017-09-29,115249,93193,64707,28486,44.0
2017-09-30,115249,90193,58351,31842,54.6
2017-10-01,115249,89766,56530,33236,58.8
2017-10-02,115249,90276,55447,34829,62.8
2017-10-03,115249,89682,48934,40748,83.3
2017-10-04,115249,90044,46004,44040,95.7
2017-10-05,115249,86206,48919,37287,76.2
2017-10-06,115249,85300,52312,32988,63.1
2017-10-07,115249,84897,54716,30181,55.2
2017-10-08,115249,84897,56165,28732,51.2
2017-10-09,115249,88352,62781,25571,40.7
2017-10-10,115249,88736,70113,18623,26.6
2017-10-11,115249,89078,68423,20655,30.2
2017-10-12,115249,89422,67158,22264,33.2
2017-10-13,115249,87471,66400,21071,31.7
2017-10-14,115249,85314,58848,26466,45.0
2017-10-15,115249,83035,56499,26536,47.0
2017-10-16,115900,84250,67783,16467,24.3
2017-10-17,115900,85546,68021,17525,25.8
2017-10-18,115900,86343,67701,18642,27.5
2017-10-19,115900,86417,68224,18193,26.7
2017-10-20,115900,87499,66981,20518,30.6
2017-10-21,115900,86319,58896,27423,46.6
2017-10-22,115900,88162,56047,32115,57.3
2017-10-23,115900,87936,67501,20435,30.3
2017-10-24,115900,86397,67971,18426,27.1
2017-10-25,115900,87495,67111,20384,30.4
2017-10-26,115900,85521,67751,17770,26.2
2017-10-27,115900,86125,66589,19536,29.3
2017-10-28,115900,83421,58510,24911,42.6
2017-10-29,115900,84929,56295,28634,50.9
2017-10-30,115900,87521,68265,19256,28.2
2017-10-31,115900,87081,67675,19406,28.7
2017-11-01,115900,85425,66262,19163,28.9
2017-11-02,115900,86093,67063,19030,28.4
2017-11-03,115900,85673,66731,18942,28.4
2017-11-04,115900,83556,58933,24623,41.8
2017-11-05,115900,85517,56809,28708,50.5
2017-11-06,115900,88088,68148,19940,29.3
2017-11-07,115900,87229,67851,19378,28.6
2017-11-08,115900,88117,66862,21255,31.8
2017-11-09,115900,88234,67500,20734,30.7
2017-11-10,115900,85972,68299,17673,25.9
2017-11-11,115900,85993,59621,26372,44.2
2017-11-12,115900,87050,57618,29432,51.1
2017-11-13,115900,87918,70689,17229,24.4
2017-11-14,115900,87731,70501,17230,24.4
2017-11-15,115900,89682,71978,17704,24.6
2017-11-16,115900,91217,72971,18246,25.0
2017-11-17,115900,92398,74345,18053,24.3
2017-11-18,115900,89274,64400,24874,38.6
2017-11-19,115900,90095,61715,28380,46.0
2017-11-20,115900,91442,76794,14648,19.1
2017-11-21,115900,90278,77327,12951,16.7
2017-11-22,115900,91187,77349,13838,17.9
2017-11-23,116278,92783,77003,15780,20.5
2017-11-24,116278,92807,77605,15202,19.6
2017-11-25,116278,86553,65980,20573,31.2
2017-11-26,116278,88497,61257,27240,44.5
2017-11-27,116278,92492,76318,16174,21.2
2017-11-28,116278,93583,76519,17064,22.3
2017-11-29,116278,93866,74378,19488,26.2
2017-11-30,116278,92483,77048,15435,20.0
2017-12-01,116278,92783,77668,15115,19.5
2017-12-02,116278,92906,66179,26727,40.4
2017-12-03,116278,91700,61218,30482,49.8
2017-12-04,116657,92064,79221,12843,16.2
2017-12-05,116657,91914,80788,11126,13.8
2017-12-06,116657,91812,80911,10901,13.5
2017-12-07,116657,91572,80127,11445,14.3
2017-12-08,116657,92551,81361,11190,13.8
2017-12-09,116657,88449,68767,19682,28.6
2017-12-10,116657,90784,64000,26784,41.9
2017-12-11,116657,95498,83927,11571,13.8
2017-12-12,116657,96095,85133,10962,12.9
2017-12-13,116657,97418,84012,13406,16.0
2017-12-14,116657,96778,84968,11810,13.9
2017-12-15,116657,96407,84115,12292,14.6
2017-12-16,116657,92603,70890,21713,30.6
2017-12-17,116657,95078,66825,28253,42.3
2017-12-18,116657,96581,84640,11941,14.1
2017-12-19,116657,97171,83873,13298,15.9
2017-12-20,116657,97205,83664,13541,16.2
2017-12-21,116657,94978,83450,11528,13.8
2017-12-22,116657,95844,81852,13992,17.1
2017-12-23,116657,93545,67211,26334,39.2
2017-12-24,116657,94461,63302,31159,49.2
2017-12-25,116657,96082,66498,29584,44.5
2017-12-26,116657,97780,81374,16406,20.2
2017-12-27,116657,98281,83589,14692,17.6
2017-12-28,116908,97955,83478,14477,17.3
2017-12-29,116908,97981,78857,19124,24.3
2017-12-30,116908,95536,64779,30757,47.5
2017-12-31,116908,96958,62446,34512,55.3
2018-01-01,116428,97398,62145,35253,56.7
2018-01-02,116428,98255,79331,18924,23.9
2018-01-03,116428,98830,81596,17234,21.1
2018-01-04,116428,98111,84027,14084,16.8
2018-01-05,116428,98798,82551,16247,19.7
2018-01-06,116428,94963,68502,26461,38.6
2018-01-07,116428,94608,64428,30180,46.8
2018-01-08,116428,98246,83012,15234,18.4
2018-01-09,116428,98786,84021,14765,17.6
2018-01-10,116428,99146,84978,14168,16.7
2018-01-11,116428,98986,85612,13374,15.6
2018-01-12,116428,98988,85497,13491,15.8
2018-01-13,116428,93735,72843,20892,28.7
2018-01-14,116428,94636,66286,28350,42.8
2018-01-15,116428,95204,80495,14709,18.3
2018-01-16,116428,96018,82564,13454,16.3
2018-01-17,116428,95696,80766,14930,18.5
2018-01-18,116428,96327,79748,16579,20.8
2018-01-19,116428,96839,79633,17206,21.6
2018-01-20,116428,92979,67813,25166,37.1
2018-01-21,116428,94866,63917,30949,48.4
2018-01-22,116428,97485,80609,16876,20.9
2018-01-23,116428,98318,85442,12876,15.1
2018-01-24,116428,98511,86277,12234,14.2
2018-01-25,116428,99147,87247,11900,13.6
2018-01-26,116428,99232,87063,12169,14.0
2018-01-27,116428,97365,74418,22947,30.8
2018-01-28,116428,95051,68496,26555,38.8
2018-01-29,116428,99605,86561,13044,15.1
2018-01-30,116428,99203,86754,12449,14.3
2018-01-31,116428,99706,85260,14446,16.9
2018-02-01,116428,100239,83904,16335,19.5
2018-02-02,116428,100029,84653,15376,18.2
2018-02-03,116428,96130,72685,23445,32.3
2018-02-04,116428,95710,69711,25999,37.3
2018-02-05,116428,100724,87623,13101,15.0
2018-02-06,116428,101148,88238,12910,14.6
2018-02-07,116428,101050,87513,13537,15.5
2018-02-08,116428,99882,87277,12605,14.4
2018-02-09,116428,100220,84660,15560,18.4
2018-02-10,116428,95524,71240,24284,34.1
2018-02-11,116428,96307,68538,27769,40.5
2018-02-12,116428,99856,86637,13219,15.3
2018-02-13,116428,99516,83809,15707,18.7
2018-02-14,116428,98260,77843,20417,26.2
2018-02-15,116428,96010,63182,32828,52.0
2018-02-16,116428,91926,57733,34193,59.2
2018-02-17,116428,91080,59867,31213,52.1
2018-02-18,116428,92300,61172,31128,50.9
2018-02-19,116428,97460,76438,21022,27.5
2018-02-20,116428,96945,79383,17562,22.1
2018-02-21,116428,97072,80128,16944,21.1
2018-02-22,116428,97291,79662,17629,22.1
2018-02-23,116428,97115,79069,18046,22.8
2018-02-24,116428,91253,66278,24975,37.7
2018-02-25,116428,94215,63005,31210,49.5
2018-02-26,116428,96486,76656,19830,25.9
2018-02-27,116428,96476,77133,19343,25.1
2018-02-28,116428,96527,78122,18405,23.6
2018-03-01,116428,93988,68728,25260,36.8
2018-03-02,116428,93668,76433,17235,22.5
2018-03-03,116428,90231,64571,25660,39.7
2018-03-04,116428,88452,58887,29565,50.2
2018-03-05,116428,91613,77198,14415,18.7
2018-03-06,116747,91932,74384,17548,23.6
2018-03-07,116747,90131,75974,14157,18.6
2018-03-08,116747,90761,78855,11906,15.1
2018-03-09,116747,90418,75922,14496,19.1
2018-03-10,116747,86257,64427,21830,33.9
2018-03-11,116747,85495,59781,25714,43.0
2018-03-12,116747,88956,73285,15671,21.4
2018-03-13,116747,90231,71017,19214,27.1
2018-03-14,116747,90597,68060,22537,33.1
2018-03-15,116747,90695,71174,19521,27.4
2018-03-16,116747,91314,72510,18804,25.9
2018-03-17,116747,87175,61946,25229,40.7
2018-03-18,116747,88083,58324,29759,51.0
2018-03-19,116747,90418,72795,17623,24.2
2018-03-20,116747,90937,72583,18354,25.3
2018-03-21,116747,90501,78017,12484,16.0
2018-03-22,116747,90196,73423,16773,22.8
2018-03-23,116747,89581,72231,17350,24.0
2018-03-24,116747,87003,61698,25305,41.0
2018-03-25,116747,86394,57513,28881,50.2
2018-03-26,116747,89715,69467,20248,29.1
2018-03-27,116747,88147,67622,20525,30.4
2018-03-28,116747,87816,66068,21748,32.9
2018-03-29,116747,87826,67110,20716,30.9
2018-03-30,116747,89166,65637,23529,35.8
2018-03-31,116747,85067,57558,27509,47.8
2018-04-01,116747,84193,56397,27796,49.3
2018-04-02,116747,83579,65846,17733,26.9
2018-04-03,116747,84946,66335,18611,28.1
2018-04-04,116747,85253,68281,16972,24.9
2018-04-05,116747,84634,70520,14114,20.0
2018-04-06,116747,83403,69296,14107,20.4
2018-04-07,116747,81063,60912,20151,33.1
2018-04-08,116747,82219,58110,24109,41.5
2018-04-09,116747,83521,68149,15372,22.6
2018-04-10,116747,82433,66523,15910,23.9
2018-04-11,116747,81614,65533,16081,24.5
2018-04-12,116747,81768,66438,15330,23.1
2018-04-13,116747,81726,66251,15475,23.4
2018-04-14,116747,81200,62481,18719,30.0
2018-04-15,116747,80067,56623,23444,41.4
2018-04-16,116747,79121,65800,13321,20.2
2018-04-17,116747,77568,66456,11112,16.7
2018-04-18,116747,78400,65506,12894,19.7
2018-04-19,116747,78924,66264,12660,19.1
2018-04-20,116747,78947,65575,13372,20.4
2018-04-21,116747,78552,57277,21275,37.1
2018-04-22,116747,77731,56420,21311,37.8
2018-04-23,116747,79894,69692,10202,14.6
2018-04-24,116747,79133,68449,10684,15.6
2018-04-25,116747,76747,64939,11808,18.2
2018-04-26,116747,78154,65403,12751,19.5
2018-04-27,116747,79175,64547,14628,22.7
2018-04-28,116747,78144,56946,21198,37.2
2018-04-29,116747,77172,55893,21279,38.1
2018-04-30,116747,80785,64781,16004,24.7
2018-05-01,116747,81580,60435,21145,35.0
2018-05-02,116747,81261,67840,13421,19.8
2018-05-03,116747,80297,65747,14550,22.1
2018-05-04,117589,81094,63828,17266,27.1
2018-05-05,117589,79174,56278,22896,40.7
2018-05-06,117589,80610,55321,25289,45.7
2018-05-07,117589,80891,60354,20537,34.0
2018-05-08,117589,79415,65600,13815,21.1
2018-05-09,117589,79444,65350,14094,21.6
2018-05-10,117589,79074,65752,13322,20.3
2018-05-11,117589,79009,65425,13584,20.8
2018-05-12,117589,75171,60553,14618,24.1
2018-05-13,117589,76940,55959,20981,37.5
2018-05-14,117589,79618,66805,12813,19.2
2018-05-15,117589,80592,70067,10525,15.0
2018-05-16,117589,82967,72229,10738,14.9
2018-05-17,117589,82000,73173,8827,12.1
2018-05-18,117589,81942,70160,11782,16.8
2018-05-19,117589,79015,57867,21148,36.5
2018-05-20,117589,78999,55326,23673,42.8
2018-05-21,117589,80612,64307,16305,25.4
2018-05-22,117589,81093,60900,20193,33.2
2018-05-23,117589,80982,65409,15573,23.8
2018-05-24,117589,79966,66977,12989,19.4
2018-05-25,117589,80698,67071,13627,20.3
2018-05-26,117589,76661,58811,17850,30.4
2018-05-27,117589,78783,56576,22207,39.3
2018-05-28,117589,80264,70232,10032,14.3
2018-05-29,117589,81615,70664,10951,15.5
2018-05-30,117589,83449,70407,13042,18.5
2018-05-31,117790,84738,69024,15714,22.8
2018-06-01,117790,83704,70127,13577,19.4
2018-06-02,117790,80601,59990,20611,34.4
2018-06-03,117790,79806,58359,21447,36.8
2018-06-04,117790,81586,71429,10157,14.2
2018-06-05,117790,82500,71221,11279,15.8
2018-06-06,117790,82133,65117,17016,26.1
2018-06-07,117790,82558,73379,9179,12.5
2018-06-08,117790,83419,71187,12232,17.2
2018-06-09,117790,82730,61116,21614,35.4
2018-06-10,117790,83297,56753,26544,46.8
2018-06-11,117790,84435,68243,16192,23.7
2018-06-12,117790,84032,68930,15102,21.9
2018-06-13,117790,85139,65009,20130,31.0
2018-06-14,117790,85370,68133,17237,25.3
2018-06-15,117790,85115,68421,16694,24.4
2018-06-16,117790,83170,58833,24337,41.4
2018-06-17,117790,83729,58275,25454,43.7
2018-06-18,117790,84329,73210,11119,15.2
2018-06-19,117790,84861,72215,12646,17.5
2018-06-20,117790,85079,72551,12528,17.3
2018-06-21,117790,86791,72656,14135,19.5
2018-06-22,117111,86209,73832,12377,16.8
2018-06-23,117111,83862,61832,22030,35.6
2018-06-24,117111,84269,60899,23370,38.4
2018-06-25,117111,87256,76606,10650,13.9
2018-06-26,117111,89067,75237,13830,18.4
2018-06-27,117111,87793,74803,12990,17.4
2018-06-28,117111,88067,74820,13247,17.7
2018-06-29,117111,89332,75049,14283,19.0
2018-06-30,117205,88076,65571,22505,34.3
2018-07-01,117205,87679,60609,27070,44.7
2018-07-02,117205,89068,75611,13457,17.8
2018-07-03,117205,89020,77312,11708,15.1
2018-07-04,117205,89359,78919,10440,13.2
2018-07-05,117205,91119,77530,13589,17.5
2018-07-06,117205,91535,73639,17896,24.3
2018-07-07,117205,89827,60855,28972,47.6
2018-07-08,117205,90879,58944,31935,54.2
2018-07-09,117205,95045,70920,24125,34.0
2018-07-10,117205,95595,76258,19337,25.4
2018-07-11,117205,96148,79406,16742,21.1
2018-07-12,117205,96809,81393,15416,18.9
2018-07-13,117205,95558,82076,13482,16.4
2018-07-14,117205,92605,70700,21905,31.0
2018-07-15,117205,93127,69798,23329,33.4
2018-07-16,117205,95758,86306,9452,11.0
2018-07-17,117205,97112,86286,10826,12.5
2018-07-18,117205,97759,86710,11049,12.7
2018-07-19,117205,97937,87591,10346,11.8
2018-07-20,117205,97502,88080,9422,10.7
2018-07-21,117205,95628,76999,18629,24.2
2018-07-22,117205,97241,73794,23447,31.8
2018-07-23,117205,98296,90695,7601,8.4
2018-07-24,117205,99570,92478,7092,7.7
2018-07-25,117205,99296,90399,8897,9.8
2018-07-26,117205,99309,90682,8627,9.5
2018-07-27,117205,99117,90678,8439,9.3
2018-07-28,117477,92232,77487,14745,19.0
2018-07-29,117477,92104,72063,20041,27.8
2018-07-30,117477,96016,82882,13134,15.8
2018-07-31,117477,96087,83087,13000,15.6
2018-08-01,117840,96321,82486,13835,16.8
2018-08-02,117840,97975,82283,15692,19.1
2018-08-03,117840,99023,81589,17434,21.4
2018-08-04,117840,95423,74087,21336,28.8
2018-08-05,117840,95002,74791,20211,27.0
2018-08-06,117840,99237,88816,10421,11.7
2018-08-07,117840,99399,88873,10526,11.8
2018-08-08,117840,99829,88955,10874,12.2
2018-08-09,117840,99902,88582,11320,12.8
2018-08-10,117840,100189,87807,12382,14.1
2018-08-11,117840,90671,75167,15504,20.6
2018-08-12,117840,90835,73509,17326,23.6
2018-08-13,117840,100194,91405,8789,9.6
2018-08-14,117840,100250,91548,8702,9.5
2018-08-15,117840,98106,83275,14831,17.8
2018-08-16,117840,99943,88720,11223,12.6
2018-08-17,117840,99458,80289,19169,23.9
2018-08-18,117840,93030,67131,25899,38.6
2018-08-19,117840,93003,66730,26273,39.4
2018-08-20,117840,99274,83917,15357,18.3
2018-08-21,117840,98147,84025,14122,16.8
2018-08-22,117840,97791,87911,9880,11.2
2018-08-23,117840,98679,84786,13893,16.4
2018-08-24,117840,98764,79844,18920,23.7
2018-08-25,117840,91111,68483,22628,33.0
2018-08-26,117840,89602,61434,28168,45.9
2018-08-27,117840,98259,77224,21035,27.2
2018-08-28,117840,98287,79359,18928,23.9
2018-08-29,117840,97798,80284,17514,21.8
2018-08-30,117996,97129,81281,15848,19.5
2018-08-31,117996,97053,77420,19633,25.4
2018-09-01,117996,92587,65117,27470,42.2
2018-09-02,117996,91846,62574,29272,46.8
2018-09-03,117996,94223,78405,15818,20.2
2018-09-04,117996,94239,76268,17971,23.6
2018-09-05,117996,94830,75416,19414,25.7
2018-09-06,117996,94775,76604,18171,23.7
2018-09-07,117996,94835,73304,21531,29.4
2018-09-08,117996,86196,61542,24654,40.1
2018-09-09,117996,88849,59747,29102,48.7
2018-09-10,117996,91723,72230,19493,27.0
2018-09-11,117996,92845,71320,21525,30.2
2018-09-12,117996,92726,73004,19722,27.0
2018-09-13,117996,92278,73607,18671,25.4
2018-09-14,117996,92337,73530,18807,25.6
2018-09-15,117996,87380,64896,22484,34.6
2018-09-16,117996,84610,61788,22822,36.9
2018-09-17,117996,92041,73080,18961,25.9
2018-09-18,117996,92418,72897,19521,26.8
2018-09-19,117996,92949,72654,20295,27.9
2018-09-20,117996,93862,71784,22078,30.8
2018-09-21,117996,95074,69729,25345,36.3
2018-09-22,117996,89729,57029,32700,57.3
2018-09-23,117996,88136,51604,36532,70.8
2018-09-24,117996,87986,47981,40005,83.4
2018-09-25,117996,87802,51414,36388,70.8
2018-09-26,117996,87542,55992,31550,56.3
2018-09-27,117996,88882,65404,23478,35.9
2018-09-28,117996,87832,66524,21308,32.0
2018-09-29,117996,85117,59632,25485,42.7
2018-09-30,117996,85610,57311,28299,49.4
2018-10-01,117996,84255,66789,17466,26.2
2018-10-02,117996,83866,66291,17575,26.5
2018-10-03,117996,82997,63204,19793,31.3
2018-10-04,117996,83069,68210,14859,21.8
2018-10-05,117996,83732,68545,15187,22.2
2018-10-06,117996,80345,60380,19965,33.1
2018-10-07,117996,80216,56947,23269,40.9
2018-10-08,117996,82849,66445,16404,24.7
2018-10-09,117996,81359,63339,18020,28.5
2018-10-10,117996,80746,67212,13534,20.1
2018-10-11,117996,82365,67931,14434,21.2
2018-10-12,117996,83471,66908,16563,24.8
2018-10-13,117996,79514,58171,21343,36.7
2018-10-14,117996,80738,57197,23541,41.2
2018-10-15,117996,82338,67919,14419,21.2
2018-10-16,117996,80683,68140,12543,18.4
2018-10-17,117996,81346,67428,13918,20.6
2018-10-18,117996,81609,68273,13336,19.5
2018-10-19,117996,81181,66699,14482,21.7
2018-10-20,117996,77857,58460,19397,33.2
2018-10-21,117996,78562,57268,21294,37.2
2018-10-22,117996,80080,67942,12138,17.9
2018-10-23,117996,79919,68261,11658,17.1
2018-10-24,117996,80567,67241,13326,19.8
2018-10-25,117996,80187,68029,12158,17.9
2018-10-26,117996,78637,68352,10285,15.0
2018-10-27,117996,78853,59055,19798,33.5
2018-10-28,117996,80886,57363,23523,41.0
2018-10-29,117996,84867,69629,15238,21.9
2018-10-30,117996,84796,70329,14467,20.6
2018-10-31,117996,84708,69211,15497,22.4
2018-11-01,117996,85019,69302,15717,22.7
2018-11-02,117996,86318,68213,18105,26.5
2018-11-03,117996,84461,59940,24521,40.9
2018-11-04,117996,83304,58032,25272,43.5
2018-11-05,117996,85339,68082,17257,25.3
2018-11-06,117996,86299,68452,17847,26.1
2018-11-07,117996,86002,70063,15939,22.7
2018-11-08,117996,88392,71046,17346,24.4
2018-11-09,117996,88746,69575,19171,27.6
2018-11-10,117996,85852,59583,26269,44.1
2018-11-11,117996,85994,58243,27751,47.6
2018-11-12,117996,88116,67888,20228,29.8
2018-11-13,117996,88097,69176,18921,27.4
2018-11-14,117996,87850,69403,18447,26.6
2018-11-15,117996,88965,69041,19924,28.9
2018-11-16,117996,89388,71160,18228,25.6
2018-11-17,118266,89280,60668,28612,47.2
2018-11-18,118266,88836,59566,29270,49.1
2018-11-19,118266,89749,71325,18424,25.8
2018-11-20,118266,89359,72086,17273,24.0
2018-11-21,118266,88807,74205,14602,19.7
2018-11-22,118266,89678,73930,15748,21.3
2018-11-23,118266,89284,74515,14769,19.8
2018-11-24,118266,89340,66283,23057,34.8
2018-11-25,118266,88825,60418,28407,47.0
2018-11-26,118266,90334,74393,15941,21.4
2018-11-27,118266,91509,74408,17101,23.0
2018-11-28,118266,92262,74495,17767,23.8
2018-11-29,118266,93480,75914,17566,23.1
2018-11-30,118266,94970,74676,20294,27.2
2018-12-01,118266,93351,63484,29867,47.0
2018-12-02,118266,91105,60232,30873,51.3
2018-12-03,118266,93342,73728,19614,26.6
2018-12-04,118266,95299,73600,21699,29.5
2018-12-05,118266,95421,76287,19134,25.1
2018-12-06,118266,94062,78157,15905,20.4
2018-12-07,118266,96189,82072,14117,17.2
2018-12-08,118266,95541,69510,26031,37.4
2018-12-09,118266,95642,67263,28379,42.2
2018-12-10,118266,97775,83776,13999,16.7
2018-12-11,118266,98271,85463,12808,15.0
2018-12-12,118266,97110,83447,13663,16.4
2018-12-13,118266,97903,83702,14201,17.0
2018-12-14,118266,98032,83871,14161,16.9
2018-12-15,118266,97154,70400,26754,38.0
2018-12-16,118266,95867,65711,30156,45.9
2018-12-17,118266,96268,81991,14277,17.4
2018-12-18,118266,95992,81939,14053,17.2
2018-12-19,118266,97325,80550,16775,20.8
2018-12-20,119092,97431,81081,16350,20.2
2018-12-21,119092,96871,79490,17381,21.9
2018-12-22,119092,94130,65656,28474,43.4
2018-12-23,119092,98751,63817,34934,54.7
2018-12-24,119092,100733,77453,23280,30.1
2018-12-25,119092,99769,67836,31933,47.1
2018-12-26,119092,101432,79897,21535,27.0
2018-12-27,119092,101923,84377,17546,20.8
2018-12-28,119092,100841,86083,14758,17.1
2018-12-29,119092,99181,71171,28010,39.4
2018-12-30,119092,98344,67295,31049,46.1
2018-12-31,119092,101763,74652,27111,36.3
2019-01-01,119092,100043,65493,34550,52.8
2019-01-02,119092,101149,82437,18712,22.7
2019-01-03,119092,99695,84196,15499,18.4
2019-01-04,119092,100294,84746,15548,18.3
2019-01-05,119092,99505,69496,30009,43.2
2019-01-06,119092,98748,66493,32255,48.5
2019-01-07,119092,101091,84074,17017,20.2
2019-01-08,119092,100948,83818,17130,20.4
2019-01-09,119092,100827,85392,15435,18.1
2019-01-10,119092,101064,83833,17231,20.6
2019-01-11,119092,99990,81941,18049,22.0
2019-01-12,119092,98303,68147,30156,44.3
2019-01-13,119092,97990,64545,33445,51.8
2019-01-14,119092,98333,81783,16550,20.2
2019-01-15,119092,98347,81378,16969,20.9
2019-01-16,119092,101806,84401,17405,20.6
2019-01-17,119092,101011,82611,18400,22.3
2019-01-18,119092,101500,81668,19832,24.3
2019-01-19,119092,99028,67950,31078,45.7
2019-01-20,119092,99561,65830,33731,51.2
2019-01-21,119092,99530,82668,16862,20.4
2019-01-22,119092,100320,81134,19186,23.6
2019-01-23,119092,100337,80794,19543,24.2
2019-01-24,119350,99535,80239,19296,24.0
2019-01-25,119350,99688,81007,18681,23.1
2019-01-26,119350,97796,68954,28842,41.8
2019-01-27,119350,97470,65189,32281,49.5
2019-01-28,119350,99745,80399,19346,24.1
2019-01-29,119350,100298,81215,19083,23.5
2019-01-30,119350,99728,80741,18987,23.5
2019-01-31,119350,99590,83652,15938,19.1
2019-02-01,119350,99950,80556,19394,24.1
2019-02-02,119350,96386,67202,29184,43.4
2019-02-03,119350,96030,60334,35696,59.2
2019-02-04,119350,94102,57603,36499,63.4
2019-02-05,119350,94577,55340,39237,70.9
2019-02-06,119350,95737,56835,38902,68.4
2019-02-07,119350,97979,72824,25155,34.5
2019-02-08,119350,99739,79253,20486,25.8
2019-02-09,119350,98259,67498,30761,45.6
2019-02-10,119350,97303,65225,32078,49.2
2019-02-11,119350,98662,81369,17293,21.3
2019-02-12,119350,98910,81684,17226,21.1
2019-02-13,119350,98297,80849,17448,21.6
2019-02-14,119350,98101,81477,16624,20.4
2019-02-15,119350,98165,81471,16694,20.5
2019-02-16,119350,95215,67769,27446,40.5
2019-02-17,119350,96719,64033,32686,51.0
2019-02-18,119350,97919,80394,17525,21.8
2019-02-19,119350,98738,82869,15869,19.1
2019-02-20,119350,97769,79777,17992,22.6
2019-02-21,119350,97508,78291,19217,24.5
2019-02-22,119350,95280,77656,17624,22.7
2019-02-23,119350,94747,65016,29731,45.7
2019-02-24,119350,92101,60881,31220,51.3
2019-02-25,119350,93529,74848,18681,25.0
2019-02-26,119350,96495,74488,22007,29.5
2019-02-27,119350,96168,74792,21376,28.6
2019-02-28,119350,96915,73115,23800,32.6
2019-03-01,119350,91637,63532,28105,44.2
2019-03-02,119350,93202,60563,32639,53.9
2019-03-03,119350,93415,59211,34204,57.8
2019-03-04,119350,91523,71880,19643,27.3
2019-03-05,119350,89577,73603,15974,21.7
2019-03-06,119350,90340,73573,16767,22.8
2019-03-07,119350,90568,72780,17788,24.4
2019-03-08,119350,91780,72390,19390,26.8
2019-03-09,119350,90590,62527,28063,44.9
2019-03-10,119350,90342,59584,30758,51.6
2019-03-11,119350,90487,72149,18338,25.4
2019-03-12,119350,90181,73773,16408,22.2
2019-03-13,119350,90422,74136,16286,22.0
2019-03-14,119350,91332,73378,17954,24.5
2019-03-15,119350,91330,73568,17762,24.1
2019-03-16,119350,91308,63088,28220,44.7
2019-03-17,119350,91088,59480,31608,53.1
2019-03-18,119350,89700,72008,17692,24.6
2019-03-19,119350,89997,70866,19131,27.0
2019-03-20,119350,88590,71675,16915,23.6
2019-03-21,119350,89654,71884,17770,24.7
2019-03-22,119350,90789,71617,19172,26.8
2019-03-23,119350,89921,62029,27892,45.0
2019-03-24,119350,90705,59274,31431,53.0
2019-03-25,119350,88593,72375,16218,22.4
2019-03-26,119350,88814,70390,18424,26.2
2019-03-27,119826,88343,68679,19664,28.6
2019-03-28,119826,87696,68576,19120,27.9
2019-03-29,119826,89996,67957,22039,32.4
2019-03-30,119826,90805,59993,30812,51.4
2019-03-31,119826,91010,59005,32005,54.2
2019-04-01,119826,89580,68918,20662,30.0
2019-04-02,119826,89630,69375,20255,29.2
2019-04-03,119826,89340,68911,20429,29.6
2019-04-04,119826,88395,68612,19783,28.8
2019-04-05,119826,88423,69788,18635,26.7
2019-04-06,119826,85244,59799,25445,42.6
2019-04-07,119826,85169,57246,27923,48.8
2019-04-08,119826,86824,66789,20035,30.0
2019-04-09,119826,87976,70499,17477,24.8
2019-04-10,119826,86455,73010,13445,18.4
2019-04-11,119826,85487,68823,16664,24.2
2019-04-12,119826,86705,65841,20864,31.7
2019-04-13,119826,83129,58741,24388,41.5
2019-04-14,119826,82158,57347,24811,43.3
2019-04-15,119826,85512,65652,19860,30.3
2019-04-16,119826,83106,65846,17260,26.2
2019-04-17,119826,82570,64858,17712,27.3
2019-04-18,119826,82853,65665,17188,26.2
2019-04-19,119826,84424,67286,17138,25.5
2019-04-20,119826,85289,57536,27753,48.2
2019-04-21,119826,83152,56357,26795,47.5
2019-04-22,119826,81942,65036,16906,26.0
2019-04-23,119826,81557,67676,13881,20.5
2019-04-24,119826,82852,66843,16009,24.0
2019-04-25,119826,83514,68406,15108,22.1
2019-04-26,119826,84099,68703,15396,22.4
2019-04-27,119826,82324,58248,24076,41.3
2019-04-28,119826,80878,56304,24574,43.6
2019-04-29,119826,82947,68904,14043,20.4
2019-04-30,119826,82853,65866,16987,25.8
2019-05-01,119826,81645,59257,22388,37.8
2019-05-02,119826,82415,64347,18068,28.1
2019-05-03,119826,81989,63488,18501,29.1
2019-05-04,119826,80918,55891,25027,44.8
2019-05-05,119826,79335,54877,24458,44.6
2019-05-06,119826,81530,59232,22298,37.6
2019-05-07,119826,79503,64119,15384,24.0
2019-05-08,119826,78364,65191,13173,20.2
2019-05-09,119826,80556,64637,15919,24.6
2019-05-10,119826,81679,65051,16628,25.6
2019-05-11,119826,79703,56737,22966,40.5
2019-05-12,119826,79573,55971,23602,42.2
2019-05-13,119826,80443,66385,14058,21.2
2019-05-14,119826,80697,66716,13981,21.0
2019-05-15,119826,80361,68076,12285,18.0
2019-05-16,119826,83421,69631,13790,19.8
2019-05-17,119826,85369,69583,15786,22.7
2019-05-18,119826,86935,58102,28833,49.6
2019-05-19,119826,85663,57545,28118,48.9
2019-05-20,119826,85532,64838,20694,31.9
2019-05-21,119826,84904,65571,19333,29.5
2019-05-22,119826,85640,66689,18951,28.4
2019-05-23,119826,85870,68535,17335,25.3
2019-05-24,119826,86270,70964,15306,21.6
2019-05-25,119826,82940,58952,23988,40.7
2019-05-26,119826,81999,57613,24386,42.3
2019-05-27,119826,86044,69700,16344,23.4
2019-05-28,119826,85268,66168,19100,28.9
2019-05-29,119826,85854,67474,18380,27.2
2019-05-30,119826,85645,68850,16795,24.4
2019-05-31,119826,87936,64992,22944,35.3
2019-06-01,119826,88112,56860,31252,55.0
2019-06-02,119826,87594,56758,30836,54.3
2019-06-03,119826,88900,69235,19665,28.4
2019-06-04,119826,90564,70611,19953,28.3
2019-06-05,119826,90898,70897,20001,28.2
2019-06-06,119826,90589,65996,24593,37.3
2019-06-07,119826,92817,65956,26861,40.7
2019-06-08,119826,88149,57222,30927,54.0
2019-06-09,119826,87928,56627,31301,55.3
2019-06-10,119826,87694,67097,20597,30.7
2019-06-11,119826,88715,67125,21590,32.2
2019-06-12,120471,88232,68360,19872,29.1
2019-06-13,120471,88551,69302,19249,27.8
2019-06-14,120471,88949,70094,18855,26.9
2019-06-15,120471,87091,58299,28792,49.4
2019-06-16,120471,86679,57589,29090,50.5
2019-06-17,120471,89409,69144,20265,29.3
2019-06-18,120471,90120,70283,19837,28.2
2019-06-19,120471,89717,71045,18672,26.3
2019-06-20,120471,90492,72419,18073,25.0
2019-06-21,120471,90556,71392,19164,26.8
2019-06-22,120471,88896,59611,29285,49.1
2019-06-23,120471,88127,58504,29623,50.6
2019-06-24,120471,90467,72358,18109,25.0
2019-06-25,120471,89869,74192,15677,21.1
2019-06-26,120471,89983,72691,17292,23.8
2019-06-27,120471,90520,75206,15314,20.4
2019-06-28,120471,90337,73877,16460,22.3
2019-06-29,121147,87932,61863,26069,42.1
2019-06-30,121147,87921,60661,27260,44.9
2019-07-01,121147,91817,73799,18018,24.4
2019-07-02,121147,92227,73871,18356,24.8
2019-07-03,121147,92712,74051,18661,25.2
2019-07-04,121147,93946,75978,17968,23.6
2019-07-05,121147,94391,77081,17310,22.5
2019-07-06,121147,91649,64664,26985,41.7
2019-07-07,121147,92607,61231,31376,51.2
2019-07-08,121147,94434,74511,19923,26.7
2019-07-09,121147,94279,74847,19432,26.0
2019-07-10,121147,95999,73582,22417,30.5
2019-07-11,121147,95381,73762,21619,29.3
2019-07-12,121147,94222,73720,20502,27.8
2019-07-13,121147,93081,62192,30889,49.7
2019-07-14,121147,93017,62384,30633,49.1
2019-07-15,121147,94590,75227,19363,25.7
2019-07-16,121147,94626,77005,17621,22.9
2019-07-17,121147,95420,77875,17545,22.5
2019-07-18,121147,95445,78538,16907,21.5
2019-07-19,121147,95691,81037,14654,18.1
2019-07-20,121147,94148,68096,26052,38.3
2019-07-21,121147,94528,64826,29702,45.8
2019-07-22,121147,97038,81923,15115,18.5
2019-07-23,121147,95593,84164,11429,13.6
2019-07-24,121147,97332,82716,14616,17.7
2019-07-25,121147,96927,82349,14578,17.7
2019-07-26,121147,97280,80943,16337,20.2
2019-07-27,121147,96160,71548,24612,34.4
2019-07-28,121147,95524,67137,28387,42.3
2019-07-29,121147,97017,80114,16903,21.1
2019-07-30,121147,97149,81567,15582,19.1
2019-07-31,121147,97185,78182,19003,24.3
2019-08-01,121147,97699,77967,19732,25.3
2019-08-02,121147,97519,77913,19606,25.2
2019-08-03,121147,94116,70485,23631,33.5
2019-08-04,121147,95160,70852,24308,34.3
2019-08-05,121147,97013,82885,14128,17.0
2019-08-06,121147,97597,82491,15106,18.3
2019-08-07,121147,98026,81077,16949,20.9
2019-08-08,121147,97218,84356,12862,15.2
2019-08-09,121147,97267,85400,11867,13.9
2019-08-10,121147,93371,75211,18160,24.1
2019-08-11,121147,94097,73304,20793,28.4
2019-08-12,121147,97108,86941,10167,11.7
2019-08-13,121147,96389,90314,6075,6.7
2019-08-14,121147,98540,90052,8488,9.4
2019-08-15,121147,96663,75693,20970,27.7
2019-08-16,121147,98046,81147,16899,20.8
2019-08-17,121147,96653,68337,28316,41.4
2019-08-18,121147,96791,66051,30740,46.5
2019-08-19,121147,98558,81590,16968,20.8
2019-08-20,121147,98607,83162,15445,18.6
2019-08-21,121147,99640,83782,15858,18.9
2019-08-22,121147,100471,82264,18207,22.1
2019-08-23,121147,100326,79012,21314,27.0
2019-08-24,121147,98115,64735,33380,51.6
2019-08-25,121147,98253,63326,34927,55.2
2019-08-26,121147,99869,79478,20391,25.7
2019-08-27,121147,99787,77998,21789,27.9
2019-08-28,121147,99232,79037,20195,25.6
2019-08-29,121147,99833,76683,23150,30.2
2019-08-30,122973,99882,73735,26147,35.5
2019-08-31,122973,97968,63393,34575,54.5
2019-09-01,122973,97308,61847,35461,57.3
2019-09-02,122973,96412,76231,20181,26.5
2019-09-03,122973,95152,77067,18085,23.5
2019-09-04,122973,95358,77939,17419,22.3
2019-09-05,122973,96786,79390,17396,21.9
2019-09-06,122973,96032,79916,16116,20.2
2019-09-07,122973,94243,68972,25271,36.6
2019-09-08,122973,92823,65686,27137,41.3
2019-09-09,122973,92717,78980,13737,17.4
2019-09-10,122490,91977,78650,13327,16.9
2019-09-11,122490,92360,73271,19089,26.1
2019-09-12,122490,89300,55025,34275,62.3
2019-09-13,122490,87867,50583,37284,73.7
2019-09-14,122490,87824,55077,32747,59.5
2019-09-15,122490,87737,58401,29336,50.2
2019-09-16,122490,88841,71926,16915,23.5
2019-09-17,122490,88944,72654,16290,22.4
2019-09-18,122490,90221,71310,18911,26.5
2019-09-19,122490,90289,71203,19086,26.8
2019-09-20,122490,89961,68997,20964,30.4
2019-09-21,122490,83252,60423,22829,37.8
2019-09-22,122490,85676,57175,28501,49.8
2019-09-23,122490,87757,67955,19802,29.1
2019-09-24,122490,87436,68030,19406,28.5
2019-09-25,122490,84067,69484,14583,21.0
2019-09-26,122490,84644,70942,13702,19.3
2019-09-27,122490,84363,70695,13668,19.3
2019-09-28,122490,83347,61652,21695,35.2
2019-09-29,122490,84097,59910,24187,40.4
2019-09-30,122490,84371,72703,11668,16.0
2019-10-01,122490,83471,73550,9921,13.5
2019-10-02,122490,85176,72674,12502,17.2
2019-10-03,122490,81703,65389,16314,24.9
2019-10-04,122490,80662,69517,11145,16.0
2019-10-05,122490,81526,58463,23063,39.4
2019-10-06,122490,83945,56929,27016,47.5
2019-10-07,122490,82629,67701,14928,22.0
2019-10-08,122490,82189,66068,16121,24.4
2019-10-09,122490,81179,62364,18815,30.2
2019-10-10,122490,80267,66814,13453,20.1
2019-10-11,122490,80279,65826,14453,22.0
2019-10-12,122490,79668,56963,22705,39.9
2019-10-13,122490,84062,56189,27873,49.6
2019-10-14,122490,80774,66445,14329,21.6
2019-10-15,122490,81374,66840,14534,21.7
2019-10-16,122490,82263,65339,16924,25.9
2019-10-17,122490,81826,65896,15930,24.2
2019-10-18,122490,82388,66319,16069,24.2
2019-10-19,122490,79662,57570,22092,38.4
2019-10-20,122490,82594,56578,26016,46.0
2019-10-21,122490,80786,66898,13888,20.8
2019-10-22,122490,81746,67468,14278,21.2
2019-10-23,122490,81763,67006,14757,22.0
2019-10-24,122490,82482,66741,15741,23.6
2019-10-25,122490,82728,65970,16758,25.4
2019-10-26,122490,83846,57066,26780,46.9
2019-10-27,122490,84834,56033,28801,51.4
2019-10-28,122490,82434,66673,15761,23.6
2019-10-29,124023,82395,67119,15276,22.8
2019-10-30,124023,81982,66526,15456,23.2
2019-10-31,124023,82886,66888,15998,23.9
2019-11-01,124023,85949,65117,20832,32.0
2019-11-02,124023,85945,56973,28972,50.9
2019-11-03,124023,86064,56036,30028,53.6
2019-11-04,124023,85676,65979,19697,29.9
2019-11-05,124023,85099,66471,18628,28.0
2019-11-06,124023,85861,65837,20024,30.4
2019-11-07,124023,88250,66635,21615,32.4
2019-11-08,124023,88048,66895,21153,31.6
2019-11-09,124023,84573,58848,25725,43.7
2019-11-10,124023,83166,57626,25540,44.3
2019-11-11,124023,85649,67084,18565,27.7
2019-11-12,124023,86750,68342,18408,26.9
2019-11-13,124392,85826,71244,14582,20.5
2019-11-14,124392,87748,72026,15722,21.8
2019-11-15,124392,86729,70876,15853,22.4
2019-11-16,124392,85664,60421,25243,41.8
2019-11-17,124392,85545,58646,26899,45.9
2019-11-18,124392,88940,71848,17092,23.8
2019-11-19,124392,87377,74393,12984,17.5
2019-11-20,124392,86728,74148,12580,17.0
2019-11-21,124392,88463,74041,14422,19.5
2019-11-22,124392,88001,71571,16430,23.0
2019-11-23,124392,83834,60030,23804,39.7
2019-11-24,124392,83730,57696,26034,45.1
2019-11-25,124392,89691,74250,15441,20.8
2019-11-26,124392,89075,72776,16299,22.4
2019-11-27,124392,87376,73684,13692,18.6
2019-11-28,124392,87908,73693,14215,19.3
2019-11-29,124392,89896,73720,16176,21.9
2019-11-30,124392,88910,62203,26707,42.9
2019-12-01,124392,85920,60978,24942,40.9
2019-12-02,124392,89693,76453,13240,17.3
2019-12-03,124392,88648,77950,10698,13.7
2019-12-04,124833,88239,76624,11615,15.2
2019-12-05,124833,90748,80251,10497,13.1
2019-12-06,124833,92934,81787,11147,13.6
2019-12-07,124833,88596,67875,20721,30.5
2019-12-08,124833,88512,64092,24420,38.1
2019-12-09,124833,91032,80600,10432,12.9
2019-12-10,124833,90073,79201,10872,13.7
2019-12-11,124833,89968,76860,13108,17.1
2019-12-12,124833,92176,78241,13935,17.8
2019-12-13,124833,93576,79110,14466,18.3
2019-12-14,124833,89108,64861,24247,37.4
2019-12-15,124833,89090,61405,27685,45.1
2019-12-16,124833,90759,76425,14334,18.8
2019-12-17,124833,90041,77487,12554,16.2
2019-12-18,124854,91281,77666,13615,17.5
2019-12-19,124854,91402,77689,13713,17.7
2019-12-20,124854,90896,79158,11738,14.8
2019-12-21,124854,88121,66564,21557,32.4
2019-12-22,124854,89528,62827,26701,42.5
2019-12-23,124854,91375,78779,12596,16.0
2019-12-24,124854,92536,79456,13080,16.5
2019-12-25,124854,92654,65610,27044,41.2
2019-12-26,124854,92905,79431,13474,17.0
2019-12-27,124854,93985,78548,15437,19.7
2019-12-28,124854,93308,65014,28294,43.5
2019-12-29,124854,94005,62540,31465,50.3
2019-12-30,124854,93749,75158,18591,24.7
2019-12-31,125338,97035,76223,20812,27.3
2020-01-01,125333,96804,64007,32797,51.2
2020-01-02,125333,95372,77180,18192,23.6
2020-01-03,125333,96134,78269,17865,22.8
2020-01-04,125333,94481,65628,28853,44.0
2020-01-05,125333,93438,63231,30207,47.8
2020-01-06,125333,93842,81890,11952,14.6
2020-01-07,125333,94123,80147,13976,17.4
2020-01-08,125333,95463,79002,16461,20.8
2020-01-09,125333,96303,79160,17143,21.7
2020-01-10,125333,95000,79247,15753,19.9
2020-01-11,125333,93323,66148,27175,41.1
2020-01-12,125333,93783,64008,29775,46.5
2020-01-13,125333,94946,80242,14704,18.3
2020-01-14,125353,94425,82329,12096,14.7
2020-01-15,125353,95018,81195,13823,17.0
2020-01-16,125358,94735,82352,12383,15.0
2020-01-17,125358,94484,81303,13181,16.2
2020-01-18,125358,91928,67399,24529,36.4
2020-01-19,125358,92976,64497,28479,44.2
2020-01-20,125358,94545,78922,15623,19.8
2020-01-21,125358,95606,79627,15979,20.1
2020-01-22,125358,94816,81438,13378,16.4
2020-01-23,125358,95986,76229,19757,25.9
2020-01-24,125358,94657,60789,33868,55.7
2020-01-25,125358,92307,54692,37615,68.8
2020-01-26,125358,91368,55281,36087,65.3
2020-01-27,125358,91781,59961,31820,53.1
2020-01-28,125358,93600,72476,21124,29.1
2020-01-29,125358,94774,76016,18758,24.7
2020-01-30,125358,95263,74457,20806,27.9
2020-01-31,125358,95312,75262,20050,26.6
2020-02-01,125358,94104,63369,30735,48.5
2020-02-02,125358,95485,61882,33603,54.3
2020-02-03,125358,95400,76775,18625,24.3
2020-02-04,125358,96258,77877,18381,23.6
2020-02-05,125358,97018,80770,16248,20.1
2020-02-06,125358,97069,81493,15576,19.1
2020-02-07,125358,96718,79761,16957,21.3
2020-02-08,125358,95448,65470,29978,45.8
2020-02-09,125358,96834,62873,33961,54.0
2020-02-10,125358,95475,76445,19030,24.9
2020-02-11,125358,94879,75830,19049,25.1
2020-02-12,125358,93859,77688,16171,20.8
2020-02-13,125887,95029,74042,20987,28.3
2020-02-14,125887,95318,72476,22842,31.5
2020-02-15,125887,93364,60935,32429,53.2
2020-02-16,125887,96078,63497,32581,51.3
2020-02-17,125887,97039,80648,16391,20.3
2020-02-18,125887,96863,80338,16525,20.6
2020-02-19,125887,96894,77972,18922,24.3
2020-02-20,125887,95750,74510,21240,28.5
2020-02-21,125887,96738,73398,23340,31.8
2020-02-22,125887,96245,62123,34122,54.9
2020-02-23,125887,96379,60988,35391,58.0
2020-02-24,125887,96071,71041,25030,35.2
2020-02-25,125887,94728,76417,18311,24.0
2020-02-26,125887,94390,72005,22385,31.1
2020-02-27,125887,93785,70327,23458,33.4
2020-02-28,125887,93914,74398,19516,26.2
2020-02-29,125887,92676,61341,31335,51.1
2020-03-01,125887,90853,59052,31801,53.9
2020-03-02,125887,93738,70171,23567,33.6
2020-03-03,125887,92536,69937,22599,32.3
2020-03-04,125887,92449,71207,21242,29.8
2020-03-05,125887,91190,71279,19911,27.9
2020-03-06,125887,91029,70461,20568,29.2
2020-03-07,125887,87952,61624,26328,42.7
2020-03-08,125887,87904,57799,30105,52.1
2020-03-09,125887,90748,69348,21400,30.9
2020-03-10,125887,90877,73329,17548,23.9
2020-03-11,125887,91229,69189,22040,31.9
2020-03-12,125887,90698,69187,21511,31.1
2020-03-13,125887,89983,69141,20842,30.1
2020-03-14,125887,85307,61420,23887,38.9
2020-03-15,125887,86578,59745,26833,44.9
2020-03-16,125887,89903,69166,20737,30.0
2020-03-17,125887,89602,70633,18969,26.9
2020-03-18,125887,88257,67700,20557,30.4
2020-03-19,125887,88786,68829,19957,29.0
2020-03-20,125887,89277,65269,24008,36.8
2020-03-21,125887,85555,58825,26730,45.4
2020-03-22,125887,84330,56264,28066,49.9
2020-03-23,125887,84764,65294,19470,29.8
2020-03-24,125887,84829,65456,19373,29.6
2020-03-25,125887,84385,64440,19945,31.0
2020-03-26,125887,83727,66984,16743,25.0
2020-03-27,125887,85189,67487,17702,26.2
2020-03-28,125887,83711,57706,26005,45.1
2020-03-29,125887,83156,56117,27039,48.2
2020-03-30,125887,86752,64310,22442,34.9
2020-03-31,125887,86469,64045,22424,35.0
2020-04-01,125887,92044,65397,26647,40.7
2020-04-02,125887,92581,64793,27788,42.9
2020-04-03,125887,92166,63334,28832,45.5
2020-04-04,125887,91190,57117,34073,59.7
2020-04-05,125887,90878,56568,34310,60.7
2020-04-06,125887,91182,64714,26468,40.9
2020-04-07,125887,90860,64082,26778,41.8
2020-04-08,125887,91327,64227,27100,42.2
2020-04-09,126262,89866,64862,25004,38.5
2020-04-10,126262,89377,63376,26001,41.0
2020-04-11,126262,88341,56756,31585,55.7
2020-04-12,126262,87889,56211,31678,56.4
2020-04-13,126262,87519,64411,23108,35.9
2020-04-14,126262,85438,62808,22630,36.0
2020-04-15,126262,85381,59614,25767,43.2
2020-04-16,126262,83416,63018,20398,32.4
2020-04-17,126262,83368,66699,16669,25.0
2020-04-18,126262,81674,55711,25963,46.6
2020-04-19,126262,83068,56027,27041,48.3
2020-04-20,126262,84130,64906,19224,29.6
2020-04-21,126262,85926,64403,21523,33.4
2020-04-22,126262,86202,63868,22334,35.0
2020-04-23,126262,85634,64118,21516,33.6
2020-04-24,126262,88897,62099,26798,43.2
2020-04-25,126262,88784,56341,32443,57.6
2020-04-26,126262,89516,54785,34731,63.4
2020-04-27,126262,90357,62669,27688,44.2
2020-04-28,126262,90838,61242,29596,48.3
2020-04-29,126262,91654,59574,32080,53.8
2020-04-30,126262,93909,55855,38054,68.1
2020-05-01,126262,92948,53435,39513,73.9
2020-05-02,126262,92659,52776,39883,75.6
2020-05-03,126262,91563,53877,37686,69.9
2020-05-04,126262,91579,57080,34499,60.4
2020-05-05,126262,91397,56310,35087,62.3
2020-05-06,126262,89731,61479,28252,46.0
2020-05-07,126580,88789,62127,26662,42.9
2020-05-08,126580,90233,62506,27727,44.4
2020-05-09,126580,87591,55520,32071,57.8
2020-05-10,126580,88343,54608,33735,61.8
2020-05-11,126580,86688,61467,25221,41.0
2020-05-12,126580,88047,61820,26227,42.4
2020-05-13,126580,89183,61203,27980,45.7
2020-05-14,126580,88998,62498,26500,42.4
2020-05-15,126580,88356,64508,23848,37.0
2020-05-16,126580,87257,54733,32524,59.4
2020-05-17,126580,90211,55310,34901,63.1
2020-05-18,126580,88211,65700,22511,34.3
2020-05-19,126580,92441,63817,28624,44.9
2020-05-20,126580,91454,61065,30389,49.8
2020-05-21,126580,90663,61329,29334,47.8
2020-05-22,126580,91340,61067,30273,49.6
2020-05-23,126580,94866,54830,40036,73.0
2020-05-24,126580,96012,54457,41555,76.3
2020-05-25,126580,94923,62174,32749,52.7
2020-05-26,126580,94878,62836,32042,51.0
2020-05-27,126580,93280,61192,32088,52.4
2020-05-28,126580,94699,61697,33002,53.5
2020-05-29,126580,93465,61765,31700,51.3
2020-05-30,126580,93168,54866,38302,69.8
2020-05-31,126798,91572,53975,37597,69.7
2020-06-01,126798,93552,62505,31047,49.7
2020-06-02,126798,92482,64274,28208,43.9
2020-06-03,126798,93068,66004,27064,41.0
2020-06-04,126798,90830,67908,22922,33.8
2020-06-05,126798,91841,67093,24748,36.9
2020-06-06,126798,90868,57796,33072,57.2
2020-06-07,126798,93095,56738,36357,64.1
2020-06-08,126798,93424,70986,22438,31.6
2020-06-09,126798,91007,73065,17942,24.6
2020-06-10,126798,91874,75247,16627,22.1
2020-06-11,126798,91127,72458,18669,25.8
2020-06-12,126798,90658,71925,18733,26.0
2020-06-13,126798,89021,61765,27256,44.1
2020-06-14,126798,89401,58071,31330,54.0
2020-06-15,126798,90337,68945,21392,31.0
2020-06-16,126798,88932,70355,18577,26.4
2020-06-17,126798,86671,71113,15558,21.9
2020-06-18,126798,88958,68208,20750,30.4
2020-06-19,127153,91543,67881,23662,34.9
2020-06-20,127153,90621,58749,31872,54.3
2020-06-21,127153,91226,58769,32457,55.2
2020-06-22,127153,92668,74046,18622,25.1
2020-06-23,127153,93139,74580,18559,24.9
2020-06-24,127153,94036,71085,22951,32.3
2020-06-25,127153,92616,70436,22180,31.5
2020-06-26,127153,94508,67237,27271,40.6
2020-06-27,127153,94225,59168,35057,59.2
2020-06-28,127153,94649,58627,36022,61.4
2020-06-29,127153,93710,71580,22130,30.9
2020-06-30,127338,96204,67390,28814,42.8
2020-07-01,127338,93570,67510,26060,38.6
2020-07-02,127338,95513,70435,25078,35.6
2020-07-03,127338,93248,69956,23292,33.3
2020-07-04,127338,90430,58241,32189,55.3
2020-07-05,127338,94623,58879,35744,60.7
2020-07-06,127338,96795,73331,23464,32.0
2020-07-07,127338,99029,72265,26764,37.0
2020-07-08,127338,98039,74371,23668,31.8
2020-07-09,127338,97338,75675,21663,28.6
2020-07-10,127338,97930,72503,25427,35.1
2020-07-11,127338,96925,61501,35424,57.6
2020-07-12,127338,98333,58411,39922,68.3
2020-07-13,127338,99746,68771,30975,45.0
2020-07-14,127338,99756,68457,31299,45.7
2020-07-15,127338,99753,68952,30801,44.7
2020-07-16,127338,100269,70509,29760,42.2
2020-07-17,127338,99492,71418,28074,39.3
2020-07-18,127338,97009,61204,35805,58.5
2020-07-19,127338,95880,62377,33503,53.7
2020-07-20,127338,98419,73800,24619,33.4
2020-07-21,127819,97779,74450,23329,31.3
2020-07-22,127819,95809,74111,21698,29.3
2020-07-23,127819,97026,72543,24483,33.7
2020-07-24,127819,95911,69401,26510,38.2
2020-07-25,127819,96250,59890,36360,60.7
2020-07-26,127819,96604,60578,36026,59.5
2020-07-27,127819,95989,73006,22983,31.5
2020-07-28,127819,96278,73747,22531,30.6
2020-07-29,127819,97376,73525,23851,32.4
2020-07-30,127819,97773,72981,24792,34.0
2020-07-31,127819,97643,72400,25243,34.9
2020-08-01,127819,97532,62900,34632,55.1
2020-08-02,127819,97712,62345,35367,56.7
2020-08-03,127819,97969,68035,29934,44.0
2020-08-04,127819,98627,71617,27010,37.7
2020-08-05,127819,98490,72543,25947,35.8
2020-08-06,127819,98650,73160,25490,34.8
2020-08-07,127819,98278,72986,25292,34.7
2020-08-08,127819,96841,64649,32192,49.8
2020-08-09,127819,98702,65302,33400,51.1
2020-08-10,127819,97823,80229,17594,21.9
2020-08-11,127819,97735,79148,18587,23.5
2020-08-12,127819,97600,82122,15478,18.8
2020-08-13,127819,99086,83777,15309,18.3
2020-08-14,127819,99312,82639,16673,20.2
2020-08-15,127819,97614,72195,25419,35.2
2020-08-16,127819,97669,70452,27217,38.6
2020-08-17,127819,97376,78553,18823,24.0
2020-08-18,127819,98698,86324,12374,14.3
2020-08-19,127819,99866,86698,13168,15.2
2020-08-20,127819,98613,86967,11646,13.4
2020-08-21,127819,99830,84425,15405,18.2
2020-08-22,127819,97583,69559,28024,40.3
2020-08-23,127819,97178,68538,28640,41.8
2020-08-24,127819,98291,85076,13215,15.5
2020-08-25,127819,97899,88574,9325,10.5
2020-08-26,127819,97951,89091,8860,9.9
2020-08-27,127819,98377,84961,13416,15.8
2020-08-28,128078,98247,85677,12570,14.7
2020-08-29,128078,94365,72836,21529,29.6
2020-08-30,128078,97818,71466,26352,36.9
2020-08-31,128078,98469,82673,15796,19.1
2020-09-01,128078,96797,82036,14761,18.0
2020-09-02,128078,96522,81356,15166,18.6
2020-09-03,128078,93299,74636,18663,25.0
2020-09-04,128078,92606,73772,18834,25.5
2020-09-05,128078,88098,61835,26263,42.5
2020-09-06,128078,91524,59566,31958,53.7
2020-09-07,128078,90928,69547,21381,30.7
2020-09-08,128078,91007,73153,17854,24.4
2020-09-09,128078,90356,71515,18841,26.3
2020-09-10,128078,89827,72738,17089,23.5
2020-09-11,128078,89004,73473,15531,21.1
2020-09-12,128078,85586,60966,24620,40.4
2020-09-13,128078,86405,59480,26925,45.3
2020-09-14,128078,88674,70702,17972,25.4
2020-09-15,128078,87732,73146,14586,19.9
2020-09-16,128078,87437,73144,14293,19.5
2020-09-17,128078,88228,71725,16503,23.0
2020-09-18,128078,89897,68259,21638,31.7
2020-09-19,128078,84851,59888,24963,41.7
2020-09-20,128078,87008,58261,28747,49.3
2020-09-21,128078,85529,67626,17903,26.5
2020-09-22,128078,85522,68157,17365,25.5
2020-09-23,128078,85480,68298,17182,25.2
2020-09-24,128078,85023,69151,15872,23.0
2020-09-25,128562,83744,67826,15918,23.5
2020-09-26,128562,82264,59397,22867,38.5
2020-09-27,128562,84816,58397,26419,45.2
2020-09-28,128562,86570,66036,20534,31.1
2020-09-29,128562,85624,60187,25437,42.3
2020-09-30,128562,85437,51986,33451,64.3
2020-10-01,128562,83392,48946,34446,70.4
2020-10-02,128562,83813,51651,32162,62.3
2020-10-03,128562,83911,53653,30258,56.4
2020-10-04,128562,84967,55638,29329,52.7
2020-10-05,128562,82923,65238,17685,27.1
2020-10-06,128562,83948,66935,17013,25.4
2020-10-07,128562,83795,66722,17073,25.6
2020-10-08,128562,85846,66261,19585,29.6
2020-10-09,128562,84994,62608,22386,35.8
2020-10-10,128562,85805,57877,27928,48.3
2020-10-11,128562,87356,57139,30217,52.9
2020-10-12,128562,87545,67195,20350,30.3
2020-10-13,128562,87140,67755,19385,28.6
2020-10-14,128562,87900,67364,20536,30.5
2020-10-15,128562,87965,67771,20194,29.8
2020-10-16,128562,88445,67349,21096,31.3
2020-10-17,128562,86170,59231,26939,45.5
2020-10-18,128562,86593,57306,29287,51.1
2020-10-19,128562,86637,67545,19092,28.3
2020-10-20,127762,86336,67824,18512,27.3
2020-10-21,127762,85999,68454,17545,25.6
2020-10-22,127762,86805,68374,18431,27.0
2020-10-23,127762,88205,67147,21058,31.4
2020-10-24,127762,87472,59213,28259,47.7
2020-10-25,127762,86531,57288,29243,51.0
2020-10-26,127762,85565,67680,17885,26.4
2020-10-27,127762,83430,67660,15770,23.3
2020-10-28,127762,84286,66752,17534,26.3
2020-10-29,128197,86310,67410,18900,28.0
2020-10-30,128197,87749,66037,21712,32.9
2020-10-31,128197,83503,57719,25784,44.7
2020-11-01,128197,82297,56822,25475,44.8
2020-11-02,128197,83707,66720,16987,25.5
2020-11-03,128197,84039,69570,14469,20.8
2020-11-04,128197,84201,69231,14970,21.6
2020-11-05,128197,84703,68907,15796,22.9
2020-11-06,128197,86273,69596,16677,24.0
2020-11-07,128197,86552,58540,28012,47.9
2020-11-08,128197,88167,57536,30631,53.2
2020-11-09,128197,87391,69999,17392,24.8
2020-11-10,128197,87738,68952,18786,27.2
2020-11-11,128197,86307,67954,18353,27.0
2020-11-12,128197,86645,68011,18634,27.4
2020-11-13,128197,85827,67692,18135,26.8
2020-11-14,128197,85450,58858,26592,45.2
2020-11-15,128197,86174,57555,28619,49.7
2020-11-16,128197,84560,68154,16406,24.1
2020-11-17,128197,87217,69082,18135,26.3
2020-11-18,128197,88630,69555,19075,27.4
2020-11-19,128197,87933,70905,17028,24.0
2020-11-20,128197,89056,71916,17140,23.8
2020-11-21,128197,90106,60121,29985,49.9
2020-11-22,128197,91702,59194,32508,54.9
2020-11-23,128197,90650,73234,17416,23.8
2020-11-24,128197,92402,73988,18414,24.9
2020-11-25,128197,93638,72888,20750,28.5
2020-11-26,128197,91860,73798,18062,24.5
2020-11-27,128609,95242,73588,21654,29.4
2020-11-28,128609,94835,63912,30923,48.4
2020-11-29,128609,94989,62162,32827,52.8
2020-11-30,128609,96827,77074,19753,25.6
2020-12-01,128609,89162,76210,12952,17.0
2020-12-02,128609,90125,77722,12403,16.0
2020-12-03,128609,90134,76904,13230,17.2
2020-12-04,128609,90619,76916,13703,17.8
2020-12-05,128609,87545,64555,22990,35.6
2020-12-06,128609,86824,62314,24510,39.3
2020-12-07,128609,89207,78832,10375,13.2
2020-12-08,128609,90949,78234,12715,16.3
2020-12-09,128609,92162,78544,13618,17.3
2020-12-10,128609,91022,80497,10525,13.1
2020-12-11,128609,91288,77669,13619,17.5
2020-12-12,128609,88706,64485,24221,37.6
2020-12-13,128609,90985,63683,27302,42.9
2020-12-14,128609,96126,84182,11944,14.2
2020-12-15,128609,97585,84708,12877,15.2
2020-12-16,128609,98795,85132,13663,16.0
2020-12-17,128609,97476,84185,13291,15.8
2020-12-18,128609,97067,82899,14168,17.1
2020-12-19,128609,94556,69628,24928,35.8
2020-12-20,128609,92484,66560,25924,38.9
2020-12-21,128609,95863,82906,12957,15.6
2020-12-22,128609,94909,82109,12800,15.6
2020-12-23,128609,96337,81349,14988,18.4
2020-12-24,128609,94665,77124,17541,22.7
2020-12-25,128609,94583,67327,27256,40.5
2020-12-26,128609,92990,63604,29386,46.2
2020-12-27,128609,92923,62840,30083,47.9
2020-12-28,128609,96902,76803,20099,26.2
2020-12-29,129191,98175,78915,19260,24.4
2020-12-30,129191,99290,83916,15374,18.3
2020-12-31,129191,99506,80632,18874,23.4
2021-01-01,128209,98477,64942,33535,51.6
2021-01-02,128209,97800,64982,32818,50.5
2021-01-03,128209,96591,66473,30118,45.3
2021-01-04,128209,97246,82840,14406,17.4
2021-01-05,128209,97905,84497,13408,15.9
2021-01-06,128209,98015,85568,12447,14.5
2021-01-07,128209,98213,90195,8018,8.9
2021-01-08,128209,98229,89858,8371,9.3
2021-01-09,128209,92949,74232,18717,25.2
2021-01-10,128209,92072,70738,21334,30.2
2021-01-11,128209,99189,90564,8625,9.5
2021-01-12,128209,98911,88089,10822,12.3
2021-01-13,128209,97325,84235,13090,15.5
2021-01-14,128209,97618,80757,16861,20.9
2021-01-15,128209,97229,78869,18360,23.3
2021-01-16,128209,95981,69347,26634,38.4
2021-01-17,128209,96509,68310,28199,41.3
2021-01-18,128209,100962,86673,14289,16.5
2021-01-19,128209,101789,85348,16441,19.3
2021-01-20,128209,99678,83468,16210,19.4
2021-01-21,128209,98432,80435,17997,22.4
2021-01-22,128209,97449,79367,18082,22.8
2021-01-23,128209,93433,65370,28063,42.9
2021-01-24,128209,95387,62201,33186,53.4
2021-01-25,128209,99244,75047,24197,32.2
2021-01-26,128209,98918,79190,19728,24.9
2021-01-27,128209,98753,77213,21540,27.9
2021-01-28,128820,99431,80655,18776,23.3
2021-01-29,128820,100187,83971,16216,19.3
2021-01-30,128820,97640,69215,28425,41.1
2021-01-31,128820,97006,63574,33432,52.6
2021-02-01,128820,97244,77878,19366,24.9
2021-02-02,128820,100311,80457,19854,24.7
2021-02-03,128820,98639,82594,16045,19.4
2021-02-04,128820,99356,80804,18552,23.0
2021-02-05,128820,98078,80698,17380,21.5
2021-02-06,128820,95591,66340,29251,44.1
2021-02-07,128820,97339,63698,33641,52.8
2021-02-08,128820,95887,77950,17937,23.0
2021-02-09,128820,95302,79114,16188,20.5
2021-02-10,128820,95532,76269,19263,25.3
2021-02-11,128820,92479,61009,31470,51.6
2021-02-12,128820,86404,54836,31568,57.6
2021-02-13,128820,87762,55686,32076,57.6
2021-02-14,128820,88705,57687,31018,53.8
2021-02-15,128820,94473,74829,19644,26.3
2021-02-16,128820,95044,80711,14333,17.8
2021-02-17,128820,95992,84749,11243,13.3
2021-02-18,128820,96048,84067,11981,14.3
2021-02-19,128820,95171,79299,15872,20.0
2021-02-20,128820,91578,64603,26975,41.8
2021-02-21,128820,90791,60140,30651,51.0
2021-02-22,128820,95782,70422,25360,36.0
2021-02-23,128820,96003,73896,22107,29.9
2021-02-24,128820,94726,76281,18445,24.2
2021-02-25,128820,94462,77701,16761,21.6
2021-02-26,128820,93769,73253,20516,28.0
2021-02-27,128820,90533,61810,28723,46.5
2021-02-28,128820,87376,59511,27865,46.8
2021-03-01,128820,91305,64904,26401,40.7
2021-03-02,128820,92526,77208,15318,19.8
2021-03-03,128820,90347,74748,15599,20.9
2021-03-04,129114,92010,76597,15413,20.1
2021-03-05,129114,90815,72682,18133,24.9
2021-03-06,129114,86139,62607,23532,37.6
2021-03-07,129114,86687,60702,25985,42.8
2021-03-08,129114,90377,71789,18588,25.9
2021-03-09,129114,90638,72893,17745,24.3
2021-03-10,129114,90175,70943,19232,27.1
2021-03-11,129114,89685,71172,18513,26.0
2021-03-12,129114,89744,73861,15883,21.5
2021-03-13,129114,83969,60715,23254,38.3
2021-03-14,129114,84416,58921,25495,43.3
2021-03-15,129114,89907,68220,21687,31.8
2021-03-16,129114,89360,68547,20813,30.4
2021-03-17,129114,88514,67684,20830,30.8
2021-03-18,129114,87913,68081,19832,29.1
2021-03-19,129114,87313,67369,19944,29.6
2021-03-20,129114,84474,61460,23014,37.4
2021-03-21,129114,85076,59578,25498,42.8
2021-03-22,129114,85853,68873,16980,24.7
2021-03-23,129114,86642,68079,18563,27.3
2021-03-24,129114,86499,68196,18303,26.8
2021-03-25,129114,86425,67429,18996,28.2
2021-03-26,129114,86356,66019,20337,30.8
2021-03-27,129114,79683,59268,20415,34.4
2021-03-28,129114,80393,57877,22516,38.9
2021-03-29,129114,84735,66819,17916,26.8
2021-03-30,129114,85885,66325,19560,29.5
2021-03-31,129114,87055,65755,21300,32.4
2021-04-01,129361,86161,66192,19969,30.2
2021-04-02,129361,86166,64600,21566,33.4
2021-04-03,129361,81169,59025,22144,37.5
2021-04-04,129361,77428,57780,19648,34.0
2021-04-05,129361,78663,66231,12432,18.8
2021-04-06,129361,76858,66622,10236,15.4
2021-04-07,129361,77395,66289,11106,16.8
2021-04-08,129361,78093,66706,11387,17.1
2021-04-09,129361,77866,65500,12366,18.9
2021-04-10,129361,77769,58226,19543,33.6
2021-04-11,129361,77347,56651,20696,36.5
2021-04-12,129361,77695,68966,8729,12.7
2021-04-13,129361,79998,66770,13228,19.8
2021-04-14,129361,79298,66263,13035,19.7
2021-04-15,129361,79439,66365,13074,19.7
2021-04-16,129361,80181,66009,14172,21.5
2021-04-17,129361,79926,58589,21337,36.4
2021-04-18,129361,79970,57397,22573,39.3
2021-04-19,129361,81777,66072,15705,23.8
2021-04-20,129361,80715,66393,14322,21.6
2021-04-21,129361,80595,65940,14655,22.2
2021-04-22,129361,79141,67265,11876,17.7
2021-04-23,129361,80306,65461,14845,22.7
2021-04-24,129361,75978,57782,18196,31.5
2021-04-25,129361,77491,56810,20681,36.4
2021-04-26,129361,77474,65456,12018,18.4
2021-04-27,129361,78696,66283,12413,18.7
2021-04-28,129361,79141,65551,13590,20.7
2021-04-29,129361,79393,66022,13371,20.3
2021-04-30,129361,78607,64304,14303,22.2
2021-05-01,128441,77837,56758,21079,37.1
2021-05-02,128441,75699,56721,18978,33.5
2021-05-03,128441,77344,65471,11873,18.1
2021-05-04,128441,79297,67838,11459,16.9
2021-05-05,128441,80360,60540,19820,32.7
2021-05-06,128441,80063,65436,14627,22.4
2021-05-07,128441,80942,64780,16162,24.9
2021-05-08,128441,80119,57311,22808,39.8
2021-05-09,128441,78634,56138,22496,40.1
2021-05-10,128441,78224,66682,11542,17.3
2021-05-11,128441,79515,66134,13381,20.2
2021-05-12,128441,76910,66063,10847,16.4
2021-05-13,128441,77778,67558,10220,15.1
2021-05-14,129540,78939,68888,10051,14.6
2021-05-15,129540,74083,60555,13528,22.3
2021-05-16,129540,73597,58503,15094,25.8
2021-05-17,129540,78759,68368,10391,15.2
2021-05-18,129540,80516,66240,14276,21.6
2021-05-19,129540,77651,62006,15645,25.2
2021-05-20,129540,80387,69140,11247,16.3
2021-05-21,129540,78706,65806,12900,19.6
2021-05-22,129540,78969,58452,20517,35.1
2021-05-23,129540,78777,56815,21962,38.7
2021-05-24,129540,80691,65847,14844,22.5
2021-05-25,129540,82567,65408,17159,26.2
2021-05-26,129540,82817,66876,15941,23.8
2021-05-27,129540,81164,67738,13426,19.8
2021-05-28,129623,81180,66069,15111,22.9
2021-05-29,129623,80035,57782,22253,38.5
2021-05-30,129623,81534,57041,24493,42.9
2021-05-31,129623,82530,66049,16481,25.0
2021-06-01,129623,81585,67332,14253,21.2
2021-06-02,129623,80613,68419,12194,17.8
2021-06-03,129623,79984,70113,9871,14.1
2021-06-04,129623,80802,64864,15938,24.6
2021-06-05,129623,80179,58611,21568,36.8
2021-06-06,129623,80130,58683,21447,36.5
2021-06-07,129623,80238,68543,11695,17.1
2021-06-08,129623,81135,69828,11307,16.2
2021-06-09,129623,85738,73387,12351,16.8
2021-06-10,129623,84887,74929,9958,13.3
2021-06-11,129623,84857,70071,14786,21.1
2021-06-12,129623,81677,62209,19468,31.3
2021-06-13,129623,83336,61518,21818,35.5
2021-06-14,129623,85516,74220,11296,15.2
2021-06-15,129623,84765,73311,11454,15.6
2021-06-16,129623,86430,72494,13936,19.2
2021-06-17,129623,84780,72670,12110,16.7
2021-06-18,129623,85313,70527,14786,21.0
2021-06-19,129623,80496,60923,19573,32.1
2021-06-20,129623,81141,61200,19941,32.6
2021-06-21,129623,85494,72382,13112,18.1
2021-06-22,129623,86284,72518,13766,19.0
2021-06-23,129623,86980,71726,15254,21.3
2021-06-24,129623,83428,72813,10615,14.6
2021-06-25,129623,84448,72763,11685,16.1
2021-06-26,129623,82911,62042,20869,33.6
2021-06-27,129623,82726,62109,20617,33.2
2021-06-28,129623,86121,74821,11300,15.1
2021-06-29,129623,87573,75854,11719,15.4
2021-06-30,131069,87887,74824,13063,17.5
2021-07-01,131069,94268,77476,16792,21.7
2021-07-02,131069,93498,76865,16633,21.6
2021-07-03,131069,90140,64612,25528,39.5
2021-07-04,131069,93065,62368,30697,49.2
2021-07-05,131069,95897,76256,19641,25.8
2021-07-06,131069,94417,79663,14754,18.5
2021-07-07,131069,95298,81086,14212,17.5
2021-07-08,131069,96234,81187,15047,18.5
2021-07-09,131069,95686,78397,17289,22.1
2021-07-10,131069,93577,67726,25851,38.2
2021-07-11,131069,93247,68518,24729,36.1
2021-07-12,131069,95006,85011,9995,11.8
2021-07-13,131069,95966,87172,8794,10.1
2021-07-14,131069,97475,88087,9388,10.7
2021-07-15,131069,98180,88551,9629,10.9
2021-07-16,131069,97850,88015,9835,11.2
2021-07-17,131069,91582,71849,19733,27.5
2021-07-18,131069,90453,72054,18399,25.5
2021-07-19,131069,98755,84586,14169,16.8
2021-07-20,131069,98376,87841,10535,12.0
2021-07-21,131069,99657,88937,10720,12.1
2021-07-22,131330,99955,89958,9997,11.1
2021-07-23,131330,99758,89812,9946,11.1
2021-07-24,131330,94507,78285,16222,20.7
2021-07-25,131330,95777,76521,19256,25.2
2021-07-26,131330,100633,89426,11207,12.5
2021-07-27,131330,100739,91141,9598,10.5
2021-07-28,131330,100846,90240,10606,11.8
2021-07-29,131330,101071,89634,11437,12.8
2021-07-30,131330,99390,87847,11543,13.1
2021-07-31,131330,92532,76776,15756,20.5
2021-08-01,131330,93539,72943,20596,28.2
2021-08-02,131330,98974,75460,23514,31.2
2021-08-03,131330,100181,77517,22664,29.2
2021-08-04,131330,99578,80073,19505,24.4
2021-08-05,131330,99341,85215,14126,16.6
2021-08-06,131330,99799,82367,17432,21.2
2021-08-07,131330,94901,75210,19691,26.2
2021-08-08,131330,94736,70201,24535,34.9
2021-08-09,131330,100772,84755,16017,18.9
2021-08-10,131330,100834,84877,15957,18.8
2021-08-11,131330,100800,83818,16982,20.3
2021-08-12,131330,98952,86355,12597,14.6
2021-08-13,131330,100125,81779,18346,22.4
2021-08-14,131330,96246,68470,27776,40.6
2021-08-15,131330,95825,68076,27749,40.8
2021-08-16,131330,95165,74559,20606,27.6
2021-08-17,131330,100178,80393,19785,24.6
2021-08-18,131330,99241,80362,18879,23.5
2021-08-19,131330,99622,79472,20150,25.4
2021-08-20,131330,100721,79554,21167,26.6
2021-08-21,131330,95487,69215,26272,38.0
2021-08-22,131330,94493,66387,28106,42.3
2021-08-23,131330,98884,79334,19550,24.6
2021-08-24,131650,99256,81241,18015,22.2
2021-08-25,131650,97998,80262,17736,22.1
2021-08-26,131650,99284,81471,17813,21.9
2021-08-27,131650,99432,78339,21093,26.9
2021-08-28,131650,94472,66357,28115,42.4
2021-08-29,131650,95099,65588,29511,45.0
2021-08-30,131650,99798,78996,20802,26.3
2021-08-31,131650,100757,77665,23092,29.7
2021-09-01,131650,98658,77228,21430,27.7
2021-09-02,131650,98606,76036,22570,29.7
2021-09-03,131650,99017,74073,24944,33.7
2021-09-04,131650,92603,63885,28718,45.0
2021-09-05,131650,91917,62545,29372,47.0
2021-09-06,131650,95624,75426,20198,26.8
2021-09-07,131650,93587,76075,17512,23.0
2021-09-08,131650,95992,74423,21569,29.0
2021-09-09,131895,95161,76594,18567,24.2
2021-09-10,131895,94120,75304,18816,25.0
2021-09-11,131895,88890,65783,23107,35.1
2021-09-12,131895,90272,64512,25760,39.9
2021-09-13,131895,90532,77820,12712,16.3
2021-09-14,131895,90371,76081,14290,18.8
2021-09-15,131895,90836,74944,15892,21.2
2021-09-16,131895,88754,75436,13318,17.7
2021-09-17,131895,88469,71837,16632,23.2
2021-09-18,131895,84328,62245,22083,35.5
2021-09-19,131895,84130,58954,25176,42.7
2021-09-20,131895,84913,55779,29134,52.2
2021-09-21,131895,85539,53652,31887,59.4
2021-09-22,131895,85961,57177,28784,50.3
2021-09-23,131895,82499,67149,15350,22.9
2021-09-24,131895,81455,68879,12576,18.3
2021-09-25,131895,80070,61851,18219,29.5
2021-09-26,131895,81338,60737,20601,33.9
2021-09-27,131895,82653,72396,10257,14.2
2021-09-28,131895,82881,74094,8787,11.9
2021-09-29,131895,84542,75683,8859,11.7
2021-09-30,131895,83670,73226,10444,14.3
2021-10-01,131895,83684,72146,11538,16.0
2021-10-02,131895,74989,62298,12691,20.4
2021-10-03,131895,74037,60876,13161,21.6
2021-10-04,131895,78098,69932,8166,11.7
2021-10-05,131895,82449,75698,6751,8.9
2021-10-06,132113,83917,73845,10072,13.6
2021-10-07,132113,82862,73754,9108,12.3
2021-10-08,132113,83473,72717,10756,14.8
2021-10-09,132113,79238,63659,15579,24.5
2021-10-10,132113,80249,61162,19087,31.2
2021-10-11,132113,81058,64647,16411,25.4
2021-10-12,132113,83052,70121,12931,18.4
2021-10-13,132113,81390,70657,10733,15.2
2021-10-14,132113,80638,71458,9180,12.8
2021-10-15,132113,78551,70778,7773,11.0
2021-10-16,132113,79999,60050,19949,33.2
2021-10-17,132113,79452,58640,20812,35.5
2021-10-18,132113,81221,69348,11873,17.1
2021-10-19,132113,81211,69823,11388,16.3
2021-10-20,132113,80245,69414,10831,15.6
2021-10-21,132113,81902,70203,11699,16.7
2021-10-22,132113,85343,67900,17443,25.7
2021-10-23,132113,81426,59042,22384,37.9
2021-10-24,132113,80298,57699,22599,39.2
2021-10-25,132113,83115,69114,14001,20.3
2021-10-26,132113,83798,69601,14197,20.4
2021-10-27,132113,83310,68937,14373,20.8
2021-10-28,132113,82479,69488,12991,18.7
2021-10-29,132113,84869,67683,17186,25.4
2021-10-30,133455,82627,59770,22857,38.2
2021-10-31,133455,83019,58161,24858,42.7
2021-11-01,133455,85827,69259,16568,23.9
2021-11-02,133455,85478,69554,15924,22.9
2021-11-03,133455,83854,69599,14255,20.5
2021-11-04,133455,84334,70149,14185,20.2
2021-11-05,133455,84602,68742,15860,23.1
2021-11-06,133455,78785,59456,19329,32.5
2021-11-07,133455,80184,58370,21814,37.4
2021-11-08,133455,86547,72602,13945,19.2
2021-11-09,133455,84443,72800,11643,16.0
2021-11-10,133455,84601,73477,11124,15.1
2021-11-11,133564,85839,74708,11131,14.9
2021-11-12,133564,85381,73855,11526,15.6
2021-11-13,133564,82198,61840,20358,32.9
2021-11-14,133564,80771,59863,20908,34.9
2021-11-15,133564,84114,71603,12511,17.5
2021-11-16,133564,84252,72310,11942,16.5
2021-11-17,133564,85564,73028,12536,17.2
2021-11-18,133564,84890,72485,12405,17.1
2021-11-19,133564,85565,70926,14639,20.6
2021-11-20,133564,82811,61390,21421,34.9
2021-11-21,133564,80551,60516,20035,33.1
2021-11-22,133564,88726,76847,11879,15.5
2021-11-23,133564,91056,79838,11218,14.1
2021-11-24,133564,93131,76210,16921,22.2
2021-11-25,133564,95904,74510,21394,28.7
2021-11-26,133564,96502,75223,21279,28.3
2021-11-27,133564,92026,63937,28089,43.9
2021-11-28,133564,91146,62027,29119,46.9
2021-11-29,133564,94302,75340,18962,25.2
2021-11-30,133564,95394,80362,15032,18.7
2021-12-01,133564,96460,81177,15283,18.8
2021-12-02,133896,95116,80145,14971,18.7
2021-12-03,133896,96839,78696,18143,23.1
2021-12-04,133896,94435,65770,28665,43.6
2021-12-05,133896,93599,64032,29567,46.2
2021-12-06,133896,100061,78083,21978,28.1
2021-12-07,133896,100638,78079,22559,28.9
2021-12-08,133896,100449,78310,22139,28.3
2021-12-09,133896,100769,78182,22587,28.9
2021-12-10,133896,100525,77936,22589,29.0
2021-12-11,133896,94870,64834,30036,46.3
2021-12-12,133896,98173,65441,32732,50.0
2021-12-13,133896,102797,82173,20624,25.1
2021-12-14,133896,101254,82571,18683,22.6
2021-12-15,133896,100450,79839,20611,25.8
2021-12-16,133896,99929,81399,18530,22.8
2021-12-17,133896,104301,85699,18602,21.7
2021-12-18,133896,98106,70883,27223,38.4
2021-12-19,133896,99975,67544,32431,48.0
2021-12-20,133896,102725,81750,20971,25.7
2021-12-21,134012,101328,80294,21034,26.2
2021-12-22,134012,101750,81451,20299,24.9
2021-12-23,134012,102837,81874,20963,25.6
2021-12-24,134012,101856,81185,20671,25.5
2021-12-25,134158,101662,72815,28847,39.6
2021-12-26,134158,101244,71719,29525,41.2
2021-12-27,134158,103554,90708,12846,14.2
2021-12-28,134158,101789,88717,13072,14.7
2021-12-29,134158,103867,85966,17901,20.8
2021-12-30,134158,105343,84564,20779,24.6
2021-12-31,134158,105752,81748,24004,29.4
2022-01-01,134020,101222,67369,33853,50.3
2022-01-02,134020,103896,68173,35723,52.4
2022-01-03,134020,107391,85196,22195,26.1
2022-01-04,134020,106705,85161,21544,25.3
2022-01-05,134020,107631,89397,18234,20.4
2022-01-06,134020,107486,84761,22725,26.8
2022-01-07,134020,107169,85425,21744,25.5
2022-01-08,134020,102853,70793,32060,45.3
2022-01-09,134020,101437,67889,33548,49.4
2022-01-10,134020,104076,85301,18775,22.0
2022-01-11,134020,107504,88103,19401,22.0
2022-01-12,134020,107063,88305,18758,21.2
2022-01-13,134020,107327,89115,18212,20.4
2022-01-14,134020,106463,87278,19185,22.0
2022-01-15,134020,99046,71585,27461,38.4
2022-01-16,134020,99043,70090,28953,41.3
2022-01-17,134020,104610,87967,16643,18.9
2022-01-18,134020,104684,87579,17105,19.5
2022-01-19,134020,104860,88076,16784,19.1
2022-01-20,134020,105164,87884,17280,19.7
2022-01-21,134020,104526,86522,18004,20.8
2022-01-22,134020,99165,72105,27060,37.5
2022-01-23,134020,100014,67726,32288,47.7
2022-01-24,134020,103205,83085,20120,24.2
2022-01-25,134123,102737,86241,16496,19.1
2022-01-26,134123,103430,82984,20446,24.6
2022-01-27,134123,103391,82938,20453,24.7
2022-01-28,134123,104633,82283,22350,27.2
2022-01-29,134123,98753,68009,30744,45.2
2022-01-30,134123,95905,65026,30879,47.5
2022-01-31,134123,95850,61339,34511,56.3
2022-02-01,133069,97064,59840,37224,62.2
2022-02-02,133069,99458,63795,35663,55.9
2022-02-03,133069,102205,78841,23364,29.6
2022-02-04,133069,102340,82614,19726,23.9
2022-02-05,133069,100908,73089,27819,38.1
2022-02-06,133069,100922,69718,31204,44.8
2022-02-07,133069,100103,87351,12752,14.6
2022-02-08,133069,102163,85352,16811,19.7
2022-02-09,133069,101527,83819,17708,21.1
2022-02-10,133069,103674,81626,22048,27.0
2022-02-11,133069,102618,81928,20690,25.3
2022-02-12,133069,100573,67542,33031,48.9
2022-02-13,133069,100238,65396,34842,53.3
2022-02-14,133069,103073,79225,23848,30.1
2022-02-15,133069,104682,83893,20789,24.8
2022-02-16,133069,103942,86687,17255,19.9
2022-02-17,133069,103184,86434,16750,19.4
2022-02-18,133069,100716,84164,16552,19.7
2022-02-19,133069,98848,70632,28216,39.9
2022-02-20,133069,96907,69627,27280,39.2
2022-02-21,133069,97347,82900,14447,17.4
2022-02-22,133069,96702,83248,13454,16.2
2022-02-23,133069,98038,85489,12549,14.7
2022-02-24,133069,97557,83453,14104,16.9
2022-02-25,133069,98432,80824,17608,21.8
2022-02-26,133069,97176,67374,29802,44.2
2022-02-27,133069,95229,64965,30264,46.6
2022-02-28,133069,91911,73959,17952,24.3
2022-03-01,133069,92392,69920,22472,32.1
2022-03-02,133069,93798,77502,16296,21.0
2022-03-03,133069,91888,77182,14706,19.1
2022-03-04,133069,89526,78189,11337,14.5
2022-03-05,133069,82102,66375,15727,23.7
2022-03-06,133069,81233,64675,16558,25.6
2022-03-07,133069,88990,77345,11645,15.1
2022-03-08,133561,90369,76762,13607,17.7
2022-03-09,133561,92928,67781,25147,37.1
2022-03-10,133561,93595,73841,19754,26.8
2022-03-11,133561,91552,74509,17043,22.9
2022-03-12,133561,83382,62114,21268,34.2
2022-03-13,133561,83055,61436,21619,35.2
2022-03-14,133561,91813,76789,15024,19.6
2022-03-15,133561,92568,71988,20580,28.6
2022-03-16,133561,87501,70966,16535,23.3
2022-03-17,133561,87346,75585,11761,15.6
2022-03-18,133561,89903,76980,12923,16.8
2022-03-19,133561,84686,66838,17848,26.7
2022-03-20,133561,83653,62882,20771,33.0
2022-03-21,133561,86078,74381,11697,15.7
2022-03-22,133561,86161,73197,12964,17.7
2022-03-23,133561,89033,78233,10800,13.8
2022-03-24,133561,83716,73156,10560,14.4
2022-03-25,133561,84019,71135,12884,18.1
2022-03-26,133561,78264,62291,15973,25.6
2022-03-27,133561,81196,60623,20573,33.9
2022-03-28,133561,83826,70765,13061,18.5
2022-03-29,133561,83223,70311,12912,18.4
2022-03-30,133561,83144,71112,12032,16.9
2022-03-31,133561,83397,70618,12779,18.1
2022-04-01,133561,86929,68838,18091,26.3
2022-04-02,133561,81417,61732,19685,31.9
2022-04-03,133561,81121,60331,20790,34.5
2022-04-04,133561,84320,69891,14429,20.6
2022-04-05,133561,84085,70446,13639,19.4
2022-04-06,133561,83820,69222,14598,21.1
2022-04-07,133561,84039,69860,14179,20.3
2022-04-08,133680,84389,67293,17096,25.4
2022-04-09,133680,78558,60137,18421,30.6
2022-04-10,133680,79188,58490,20698,35.4
2022-04-11,133680,83037,68821,14216,20.7
2022-04-12,133680,84159,69958,14201,20.3
2022-04-13,133680,84457,71879,12578,17.5
2022-04-14,133680,84050,71334,12716,17.8
2022-04-15,133680,83940,67132,16808,25.0
2022-04-16,133680,77102,59944,17158,28.6
2022-04-17,133680,77578,58749,18829,32.0
2022-04-18,133680,80747,67906,12841,18.9
2022-04-19,133680,82152,68498,13654,19.9
2022-04-20,133680,82087,67702,14385,21.2
2022-04-21,133680,82006,68547,13459,19.6
2022-04-22,133680,82377,67015,15362,22.9
2022-04-23,133680,77509,58909,18600,31.6
2022-04-24,133680,77599,58501,19098,32.6
2022-04-25,133680,82516,69646,12870,18.5
2022-04-26,133680,81625,69997,11628,16.6
2022-04-27,133680,83673,67404,16269,24.1
2022-04-28,133680,82861,68086,14775,21.7
2022-04-29,133680,83895,67684,16211,24.0
2022-04-30,133680,81336,58925,22411,38.0
2022-05-01,133680,80599,57624,22975,39.9
2022-05-02,133680,84804,67357,17447,25.9
2022-05-03,133680,85122,68221,16901,24.8
2022-05-04,133917,84671,66896,17775,26.6
2022-05-05,133917,82440,62398,20042,32.1
2022-05-06,133917,83815,65275,18540,28.4
2022-05-07,133917,74588,58240,16348,28.1
2022-05-08,133917,78693,57573,21120,36.7
2022-05-09,133917,82664,68295,14369,21.0
2022-05-10,133917,81916,68449,13467,19.7
2022-05-11,133917,82127,69284,12843,18.5
2022-05-12,133917,78815,69519,9296,13.4
2022-05-13,133917,81648,70215,11433,16.3
2022-05-14,133917,77018,59523,17495,29.4
2022-05-15,133917,80194,58322,21872,37.5
2022-05-16,133917,81117,68158,12959,19.0
2022-05-17,133917,78740,69598,9142,13.1
2022-05-18,133917,80022,69000,11022,16.0
2022-05-19,133917,78739,68981,9758,14.1
2022-05-20,133917,78019,68019,10000,14.7
2022-05-21,133917,73392,60962,12430,20.4
2022-05-22,133917,77792,60230,17562,29.2
2022-05-23,133917,81075,72122,8953,12.4
2022-05-24,133917,81847,72576,9271,12.8
2022-05-25,133917,82910,72539,10371,14.3
2022-05-26,133917,82378,69479,12899,18.6
2022-05-27,133917,82016,68961,13055,18.9
2022-05-28,133917,76955,61733,15222,24.7
2022-05-29,133917,79357,60948,18409,30.2
2022-05-30,133917,84474,73134,11340,15.5
2022-05-31,133917,84553,69888,14665,21.0
2022-06-01,134186,79189,64790,14399,22.2
2022-06-02,134186,83606,71717,11889,16.6
2022-06-03,134186,84094,72128,11966,16.6
2022-06-04,134186,82590,62408,20182,32.3
2022-06-05,134186,80301,58600,21701,37.0
2022-06-06,134186,83093,61814,21279,34.4
2022-06-07,134186,85109,70522,14587,20.7
2022-06-08,134060,85703,68480,17223,25.2
2022-06-09,134060,86254,69993,16261,23.2
2022-06-10,134060,85397,71317,14080,19.7
2022-06-11,134060,81919,62034,19885,32.1
2022-06-12,134060,82389,61303,21086,34.4
2022-06-13,134060,87376,71248,16128,22.6
2022-06-14,134060,86350,71477,14873,20.8
2022-06-15,134066,85748,69275,16473,23.8
2022-06-16,134066,85906,70925,14981,21.1
2022-06-17,134066,87896,73461,14435,19.6
2022-06-18,134066,85104,64277,20827,32.4
2022-06-19,134066,85859,64404,21455,33.3
2022-06-20,134066,87774,77816,9958,12.8
2022-06-21,134066,91094,81164,9930,12.2
2022-06-22,134092,91108,80941,10167,12.6
2022-06-23,134092,91404,83449,7955,9.5
2022-06-24,134092,92119,76118,16001,21.0
2022-06-25,134092,84436,69554,14882,21.4
2022-06-26,134092,86439,68906,17533,25.4
2022-06-27,134092,94364,84739,9625,11.4
2022-06-28,134092,93797,84057,9740,11.6
2022-06-29,134237,95432,84492,10940,12.9
2022-06-30,134237,93599,82731,10868,13.1
2022-07-01,134237,93231,83309,9922,11.9
2022-07-02,134237,88500,74974,13526,18.0
2022-07-03,134237,87495,74464,13031,17.5
2022-07-04,134237,99188,89337,9851,11.0
2022-07-05,134237,99463,90855,8608,9.5
2022-07-06,134239,99959,91938,8021,8.7
2022-07-07,134239,99716,92990,6726,7.2
2022-07-08,134239,99997,86475,13522,15.6
2022-07-09,134239,96076,75216,20860,27.7
2022-07-10,134239,96494,75168,21326,28.4
2022-07-11,134239,100015,86943,13072,15.0
2022-07-12,134239,99071,87250,11821,13.5
2022-07-13,134266,100299,85034,15265,18.0
2022-07-14,134266,100515,85530,14985,17.5
2022-07-15,134266,100653,83272,17381,20.9
2022-07-16,134266,96946,71327,25619,35.9
2022-07-17,134266,96711,70356,26355,37.5
2022-07-18,134266,97680,83578,14102,16.9
2022-07-19,134266,99472,84631,14841,17.5
2022-07-20,134269,99728,85756,13972,16.3
2022-07-21,134269,99835,82156,17679,21.5
2022-07-22,134269,100057,80509,19548,24.3
2022-07-23,134269,96461,70266,26195,37.3
2022-07-24,134269,96305,69817,26488,37.9
2022-07-25,134269,99610,84338,15272,18.1
2022-07-26,134269,100295,87347,12948,14.8
2022-07-27,134291,100687,85507,15180,17.8
2022-07-28,134291,100467,87405,13062,14.9
2022-07-29,134291,101383,87601,13782,15.7
2022-07-30,134291,96642,76651,19991,26.1
2022-07-31,134291,97211,72224,24987,34.6
2022-08-01,134291,99761,80055,19706,24.6
2022-08-02,134291,99741,77981,21760,27.9
2022-08-03,134417,100831,81174,19657,24.2
2022-08-04,134417,101790,85866,15924,18.5
2022-08-05,134417,102311,86550,15761,18.2
2022-08-06,134417,100321,80391,19930,24.8
2022-08-07,134417,100210,78998,21212,26.9
2022-08-08,134417,100691,89263,11428,12.8
2022-08-09,134417,100864,88479,12385,14.0
2022-08-10,134446,100922,85666,15256,17.8
2022-08-11,134446,100101,85488,14613,17.1
2022-08-12,134446,100802,85622,15180,17.7
2022-08-13,134446,95281,73971,21310,28.8
2022-08-14,134446,95386,74228,21158,28.5
2022-08-15,134446,99379,80123,19256,24.0
2022-08-16,134446,101402,86440,14962,17.3
2022-08-17,134446,101195,84518,16677,19.7
2022-08-18,134462,101828,83585,18243,21.8
2022-08-19,134462,100632,86684,13948,16.1
2022-08-20,134462,95284,76241,19043,25.0
2022-08-21,134462,96045,73895,22150,30.0
2022-08-22,134462,102558,86842,15716,18.1
2022-08-23,134462,101268,86792,14476,16.7
2022-08-24,134509,101820,79100,22720,28.7
2022-08-25,134509,102008,79448,22560,28.4
2022-08-26,134509,102136,77935,24201,31.1
2022-08-27,134509,97877,64721,33156,51.2
2022-08-28,134509,96902,64155,32747,51.0
2022-08-29,134509,98962,75328,23634,31.4
2022-08-30,134509,99404,77097,22307,28.9
2022-08-31,134695,99257,74990,24267,32.4
2022-09-01,134695,98608,78089,20519,26.3
2022-09-02,134695,99473,77142,22331,28.9
2022-09-03,134695,95712,67164,28548,42.5
2022-09-04,134695,97062,67901,29161,42.9
2022-09-05,134695,97945,79872,18073,22.6
2022-09-06,134695,97699,73602,24097,32.7
2022-09-07,134702,98348,73807,24541,33.3
2022-09-08,134702,95199,67681,27518,40.7
2022-09-09,134702,94422,57303,37119,64.8
2022-09-10,134702,93326,53936,39390,73.0
2022-09-11,134702,91779,57250,34529,60.3
2022-09-12,134702,91334,61790,29544,47.8
2022-09-13,134702,92082,75687,16395,21.7
2022-09-14,134702,93018,76406,16612,21.7
2022-09-15,134719,91430,79407,12023,15.1
2022-09-16,134719,91923,82122,9801,11.9
2022-09-17,134719,87077,71108,15969,22.5
2022-09-18,134719,89824,70720,19104,27.0
2022-09-19,134719,92433,78589,13844,17.6
2022-09-20,134719,88671,73548,15123,20.6
2022-09-21,134725,87357,72071,15286,21.2
2022-09-22,134725,87478,72184,15294,21.2
2022-09-23,134725,89172,70071,19101,27.3
2022-09-24,134725,87890,61033,26857,44.0
2022-09-25,134725,87931,59920,28011,46.7
2022-09-26,134725,89385,71400,17985,25.2
2022-09-27,134725,88928,72742,16186,22.3
2022-09-28,134725,88782,72806,15976,21.9
2022-09-29,134768,87139,73018,14121,19.3
2022-09-30,134768,88547,71844,16703,23.2
2022-10-01,134768,83632,61848,21784,35.2
2022-10-02,134768,84572,59834,24738,41.3
2022-10-03,134768,86928,66998,19930,29.7
2022-10-04,134768,86098,72544,13554,18.7
2022-10-05,134768,85928,70074,15854,22.6
2022-10-06,134797,86440,70544,15896,22.5
2022-10-07,134797,87225,68983,18242,26.4
2022-10-08,134797,85508,59871,25637,42.8
2022-10-09,134797,86454,58315,28139,48.3
2022-10-10,134797,84696,62700,21996,35.1
2022-10-11,134797,84595,70344,14251,20.3
2022-10-12,134797,83927,69872,14055,20.1
2022-10-13,134824,83262,70316,12946,18.4
2022-10-14,134824,82757,69004,13753,19.9
2022-10-15,134824,82961,60625,22336,36.8
2022-10-16,134824,84594,59248,25346,42.8
2022-10-17,134824,86767,70021,16746,23.9
2022-10-18,134824,86919,70701,16218,22.9
2022-10-19,134823,85998,70250,15748,22.4
2022-10-20,134823,84256,70976,13280,18.7
2022-10-21,134823,83851,69240,14611,21.1
2022-10-22,134823,80425,60433,19992,33.1
2022-10-23,134823,82226,58500,23726,40.6
2022-10-24,134823,83828,70139,13689,19.5
2022-10-25,134823,85434,70495,14939,21.2
2022-10-26,134823,84774,70052,14722,21.0
2022-10-27,134823,85104,70573,14531,20.6
2022-10-28,134823,84939,68956,15983,23.2
2022-10-29,134823,82677,59900,22777,38.0
2022-10-30,134823,83152,58605,24547,41.9
2022-10-31,136031,86565,69769,16796,24.1
2022-11-01,136031,82712,69729,12983,18.6
2022-11-02,136031,84799,69282,15517,22.4
2022-11-03,136031,84448,71242,13206,18.5
2022-11-04,136031,84682,70733,13949,19.7
2022-11-05,136031,84711,61328,23383,38.1
2022-11-06,136031,83073,59724,23349,39.1
2022-11-07,136031,85170,71020,14150,19.9
2022-11-08,136031,84526,69806,14720,21.1
2022-11-09,136200,83208,69966,13242,18.9
2022-11-10,136200,83233,69764,13469,19.3
2022-11-11,136200,82359,69415,12944,18.6
2022-11-12,136200,81862,60675,21187,34.9
2022-11-13,136200,83142,60054,23088,38.4
2022-11-14,136200,85353,71165,14188,19.9
2022-11-15,136200,86049,72431,13618,18.8
2022-11-16,136207,86564,71687,14877,20.8
2022-11-17,136207,85468,71642,13826,19.3
2022-11-18,136207,84158,70458,13700,19.4
2022-11-19,136207,83590,60856,22734,37.4
2022-11-20,136207,85105,60057,25048,41.7
2022-11-21,136207,86966,71811,15155,21.1
2022-11-22,136207,86178,74117,12061,16.3
2022-11-23,136249,85867,71774,14093,19.6
2022-11-24,136249,85945,72420,13525,18.7
2022-11-25,136249,87034,70886,16148,22.8
2022-11-26,136249,86934,61907,25027,40.4
2022-11-27,136249,87912,61147,26765,43.8
2022-11-28,136249,87897,74855,13042,17.4
2022-11-29,136249,91100,75720,15380,20.3
2022-11-30,136268,92682,82117,10565,12.9
2022-12-01,136268,96487,83052,13435,16.2
2022-12-02,136268,94957,80829,14128,17.5
2022-12-03,136268,92219,67989,24230,35.6
2022-12-04,136268,94440,67707,26733,39.5
2022-12-05,136268,96977,83990,12987,15.5
2022-12-06,136268,97332,84058,13274,15.8
2022-12-07,137861,96563,82135,14428,17.6
2022-12-08,137861,97385,81462,15923,19.5
2022-12-09,137861,97136,82223,14913,18.1
2022-12-10,137861,93012,67446,25566,37.9
2022-12-11,137861,96222,65907,30315,46.0
2022-12-12,137861,97985,83311,14674,17.6
2022-12-13,137861,98308,85195,13113,15.4
2022-12-14,137875,100637,90128,10509,11.7
2022-12-15,137875,102168,88874,13294,15.0
2022-12-16,137875,101510,89583,11927,13.3
2022-12-17,137875,101175,74303,26872,36.2
2022-12-18,137875,101564,73852,27712,37.5
2022-12-19,137875,103828,91710,12118,13.2
2022-12-20,137875,104369,90571,13798,15.2
2022-12-21,137938,103274,92698,10576,11.4
2022-12-22,137938,104749,92999,11750,12.6
2022-12-23,137938,105628,94509,11119,11.8
2022-12-24,137938,101805,75010,26795,35.7
2022-12-25,137938,103170,71213,31957,44.9
2022-12-26,137938,103765,89935,13830,15.4
2022-12-27,137938,105048,89282,15766,17.7
2022-12-28,138018,103841,88939,14902,16.8
2022-12-29,138018,103136,86768,16368,18.9
2022-12-30,138018,104511,83307,21204,25.5
2022-12-31,138018,102234,68466,33768,49.3
2023-01-01,138018,103636,66465,37171,55.9
2023-01-02,138018,104849,85269,19580,23.0
2023-01-03,138018,103751,87110,16641,19.1
2023-01-04,138193,105387,87191,18196,20.9
2023-01-05,138193,103422,89012,14410,16.2
2023-01-06,138193,100386,86606,13780,15.9
2023-01-07,138193,97543,70729,26814,37.9
2023-01-08,138193,98882,68090,30792,45.2
2023-01-09,138193,102864,84683,18181,21.5
2023-01-10,138193,103335,83973,19362,23.1
2023-01-11,138280,103840,83078,20762,25.0
2023-01-12,138280,105269,82287,22982,27.9
2023-01-13,138280,104134,81907,22227,27.1
2023-01-14,138280,102803,69388,33415,48.2
2023-01-15,138280,103949,69166,34783,50.3
2023-01-16,138280,106545,84582,21963,26.0
2023-01-17,138280,107179,86815,20364,23.5
2023-01-18,138399,104805,85627,19178,22.4
2023-01-19,138399,103674,84465,19209,22.7
2023-01-20,138399,105249,81244,24005,29.5
2023-01-21,138399,99057,68910,30147,43.7
2023-01-22,138399,98334,60143,38191,63.5
2023-01-23,138399,100500,62575,37925,60.6
2023-01-24,138399,101038,72643,28395,39.1
2023-01-25,138399,103636,87275,16361,18.7
2023-01-26,138399,103138,92613,10525,11.4
2023-01-27,138643,103908,89833,14075,15.7
2023-01-28,138643,98523,74081,24442,33.0
2023-01-29,138643,98222,69956,28266,40.4
2023-01-30,138643,101644,83568,18076,21.6
2023-01-31,138643,101699,84058,17641,21.0
2023-02-01,138647,102478,81652,20826,25.5
2023-02-02,138647,101827,83228,18599,22.3
2023-02-03,138647,101103,84290,16813,19.9
2023-02-04,138647,100826,70005,30821,44.0
2023-02-05,138647,100338,67195,33143,49.3
2023-02-06,138647,100804,81935,18869,23.0
2023-02-07,138647,97301,81585,15716,19.3
2023-02-08,138817,99128,81028,18100,22.3
2023-02-09,138817,99329,80850,18479,22.9
2023-02-10,138817,99009,81340,17669,21.7
2023-02-11,138817,97867,67796,30071,44.4
2023-02-12,138817,98838,65888,32950,50.0
2023-02-13,138817,99986,81235,18751,23.1
2023-02-14,138817,98967,79024,19943,25.2
2023-02-15,138840,99470,80643,18827,23.3
2023-02-16,138840,99109,81126,17983,22.2
2023-02-17,138840,98378,79701,18677,23.4
2023-02-18,138840,94387,68387,26000,38.0
2023-02-19,138840,97215,65618,31597,48.2
2023-02-20,138840,97609,78791,18818,23.9
2023-02-21,138840,97554,79297,18257,23.0
2023-02-22,138846,98864,78537,20327,25.9
2023-02-23,138846,99004,76790,22214,28.9
2023-02-24,138846,98287,76151,22136,29.1
2023-02-25,138846,96966,66816,30150,45.1
2023-02-26,138846,96610,64923,31687,48.8
2023-02-27,138846,95543,74630,20913,28.0
2023-02-28,138846,95866,74655,21211,28.4
2023-03-01,138846,92683,69174,23509,34.0
2023-03-02,138860,97952,76510,21442,28.0
2023-03-03,138860,98244,75363,22881,30.4
2023-03-04,138860,90987,64218,26769,41.7
2023-03-05,138860,87307,62329,24978,40.1
2023-03-06,138860,92749,72424,20325,28.1
2023-03-07,138860,93336,72608,20728,28.5
2023-03-08,138866,92310,70657,21653,30.6
2023-03-09,138866,92036,72032,20004,27.8
2023-03-10,138866,91060,68901,22159,32.2
2023-03-11,138866,84465,60181,24284,40.4
2023-03-12,138866,85088,62216,22872,36.8
2023-03-13,138866,90608,72805,17803,24.5
2023-03-14,138866,89931,70755,19176,27.1
2023-03-15,139011,88788,70533,18255,25.9
2023-03-16,139011,88531,72068,16463,22.8
2023-03-17,139011,89299,71612,17687,24.7
2023-03-18,139011,86856,61605,25251,41.0
2023-03-19,139011,84692,60568,24124,39.8
2023-03-20,139011,83818,69333,14485,20.9
2023-03-21,139011,87042,68985,18057,26.2
2023-03-22,139025,85956,68792,17164,25.0
2023-03-23,139025,85967,71388,14579,20.4
2023-03-24,139025,88027,68133,19894,29.2
2023-03-25,139025,82416,60553,21863,36.1
2023-03-26,139025,83053,59275,23778,40.1
2023-03-27,139025,88424,69047,19377,28.1
2023-03-28,139025,86976,69012,17964,26.0
2023-03-29,139049,87768,68140,19628,28.8
2023-03-30,139049,86801,67833,18968,28.0
2023-03-31,139049,85199,65629,19570,29.8
2023-04-01,139049,81707,59002,22705,38.5
2023-04-01,139049,81707,59002,22705,38.5
2023-04-02,139049,85228,58205,27023,46.4
2023-04-02,139049,85228,58205,27023,46.4
2023-04-03,139049,84289,67649,16640,24.6
2023-04-03,139049,84289,67649,16640,24.6
2023-04-04,139049,84938,68535,16403,23.9
2023-04-04,139049,84938,68535,16403,23.9
2023-04-05,139079,84179,72292,11887,16.4
2023-04-05,139079,84179,72292,11887,16.4
2023-04-06,139079,84070,70688,13382,18.9
2023-04-06,139079,84070,70688,13382,18.9
2023-04-07,139079,85615,66780,18835,28.2
2023-04-07,139079,85615,66780,18835,28.2
2023-04-08,139079,84600,59967,24633,41.1
2023-04-08,139079,84600,59967,24633,41.1
2023-04-09,139079,83956,58648,25308,43.2
2023-04-09,139079,83956,58648,25308,43.2
2023-04-10,139079,83951,67150,16801,25.0
2023-04-10,139079,83951,67150,16801,25.0
2023-04-11,139079,83307,69385,13922,20.1
2023-04-12,139048,83551,67710,15841,23.4
2023-04-13,139048,82778,67686,15092,22.3
2023-04-14,139048,82131,67403,14728,21.9
2023-04-15,139048,79939,59880,20059,33.5
2023-04-16,139048,81738,58530,23208,39.7
2023-04-17,139048,82728,67016,15712,23.4
2023-04-18,139048,82167,71402,10765,15.1
2023-04-19,139100,84523,67904,16619,24.5
2023-04-20,139100,84194,69019,15175,22.0
2023-04-21,139100,84862,65953,18909,28.7
2023-04-22,139100,81689,58620,23069,39.4
2023-04-23,139100,81460,57975,23485,40.5
2023-04-24,139100,80652,66664,13988,21.0
2023-04-25,139100,82630,69358,13272,19.1
2023-04-26,139065,82164,66959,15205,22.7
2023-04-27,139065,80656,66708,13948,20.9
2023-04-28,139065,81098,65812,15286,23.2
2023-04-29,139065,80693,59105,21588,36.5
2023-04-30,139065,78787,56344,22443,39.8
2023-05-01,139065,84199,58849,25350,43.1
2023-05-02,139065,83580,66341,17239,26.0
2023-05-03,139065,84319,66914,17405,26.0
2023-05-04,139065,85400,66972,18428,27.5
2023-05-05,139065,82783,61504,21279,34.6
2023-05-06,139065,81015,57640,23375,40.6
2023-05-07,139065,82320,57038,25282,44.3
2023-05-08,139065,82152,65456,16696,25.5
2023-05-09,139065,82009,66833,15176,22.7
2023-05-10,139147,82235,66339,15896,24.0
2023-05-11,139147,83347,67295,16052,23.9
2023-05-12,139147,82904,65469,17435,26.6
2023-05-13,139147,82692,59028,23664,40.1
2023-05-14,139147,82371,58026,24345,42.0
2023-05-15,139147,82771,67563,15208,22.5
2023-05-16,139147,81823,69942,11881,17.0
2023-05-17,139171,81136,69974,11162,16.0
2023-05-18,139171,84042,70912,13130,18.5
2023-05-19,139171,82309,67914,14395,21.2
2023-05-20,140240,81884,60092,21792,36.3
2023-05-21,140240,83862,58588,25274,43.1
2023-05-22,140240,82998,67579,15419,22.8
2023-05-23,140240,82407,67974,14433,21.2
2023-05-24,140240,81333,67877,13456,19.8
2023-05-25,140240,83621,68519,15102,22.0
2023-05-26,140240,84268,68018,16250,23.9
2023-05-27,140240,82676,60765,21911,36.1
2023-05-28,140240,79202,59003,20199,34.2
2023-05-29,140240,79383,65013,14370,22.1
2023-05-30,140240,82332,72772,9560,13.1
2023-05-31,140240,83165,69289,13876,20.0
2023-06-01,140758,83644,71202,12442,17.5
2023-06-02,140758,82669,68262,14407,21.1
2023-06-03,140758,82672,59502,23170,38.9
2023-06-04,140758,84682,59372,25310,42.6
2023-06-05,140758,84710,65659,19051,29.0
2023-06-06,140758,86513,63781,22732,35.6
2023-06-07,140758,85092,69540,15552,22.4
2023-06-08,140758,85279,70755,14524,20.5
2023-06-09,140758,83619,69747,13872,19.9
2023-06-10,140758,82997,61953,21044,34.0
2023-06-11,140758,82473,62339,20134,32.3
2023-06-12,140758,87631,71512,16119,22.5
2023-06-13,140758,86678,72258,14420,20.0
2023-06-14,140908,86792,71475,15317,21.4
2023-06-15,140908,84221,72139,12082,16.7
2023-06-16,140908,85483,72163,13320,18.5
2023-06-17,140908,83897,63664,20233,31.8
2023-06-18,140908,84025,64094,19931,31.1
2023-06-19,140908,91145,79351,11794,14.9
2023-06-20,140908,91012,76566,14446,18.9
2023-06-21,140945,90548,75890,14658,19.3
2023-06-22,140945,90532,73402,17130,23.3
2023-06-23,140945,90105,73677,16428,22.3
2023-06-24,140945,88311,66496,21815,32.8
2023-06-25,140945,86380,66484,19896,29.9
2023-06-26,140945,93188,79558,13630,17.1
2023-06-27,140945,93711,77801,15910,20.4
2023-06-28,140945,94576,79205,15371,19.4
2023-06-29,140955,93562,82196,11366,13.8
2023-06-30,140955,93460,79294,14166,17.9
2023-07-01,140955,95423,69581,25842,37.1
2023-07-02,140955,95689,69809,25880,37.1
2023-07-03,140955,98483,84023,14460,17.2
2023-07-04,140955,97789,83089,14700,17.7
2023-07-05,141984,98922,77283,21639,28.0
2023-07-06,141984,99885,82268,17617,21.4
2023-07-07,141984,96783,82068,14715,17.9
2023-07-08,141984,94216,69633,24583,35.3
2023-07-09,141984,95134,68423,26711,39.0
2023-07-10,141984,99558,82203,17355,21.1
2023-07-11,141984,98896,83533,15363,18.4
2023-07-12,142126,99381,82046,17335,21.1
2023-07-13,142126,98496,84575,13921,16.5
2023-07-14,142126,98278,84380,13898,16.5
2023-07-15,142126,94588,70903,23685,33.4
2023-07-16,142126,95585,68041,27544,40.5
2023-07-17,142126,102562,82555,20007,24.2
2023-07-18,142126,101987,82615,19372,23.4
2023-07-19,142201,103424,80874,22550,27.9
2023-07-20,142201,104568,83731,20837,24.9
2023-07-21,142201,103301,84221,19080,22.7
2023-07-22,142201,99735,72220,27515,38.1
2023-07-23,142201,99820,70370,29450,41.9
2023-07-24,142201,102648,83062,19586,23.6
2023-07-25,142201,103526,83943,19583,23.3
2023-07-26,142201,103142,86054,17088,19.9
2023-07-27,142201,102234,87033,15201,17.5
2023-07-28,142567,102152,85321,16831,19.7
2023-07-29,142567,99446,76405,23041,30.2
2023-07-30,142567,100571,74605,25966,34.8
2023-07-31,142567,101789,80734,21055,26.1
2023-08-01,142567,101734,82962,18772,22.6
2023-08-02,142567,102567,82699,19868,24.0
2023-08-03,142567,101997,85990,16007,18.6
2023-08-04,142567,101133,86089,15044,17.5
2023-08-05,142567,101731,80221,21510,26.8
2023-08-06,142567,101793,79971,21822,27.3
2023-08-07,142567,104297,93615,10682,11.4
2023-08-08,142567,103860,93299,10561,11.3
2023-08-09,142584,103773,89935,13838,15.4
2023-08-10,142584,102841,81651,21190,26.0
2023-08-11,142584,103881,80549,23332,29.0
2023-08-12,142584,99351,69688,29663,42.6
2023-08-13,142584,99087,72148,26939,37.3
2023-08-14,142584,102576,82760,19816,23.9
2023-08-15,142584,102421,80630,21791,27.0
2023-08-16,142584,102713,86140,16573,19.2
2023-08-17,142584,102798,86794,16004,18.4
2023-08-18,142584,102810,88570,14240,16.1
2023-08-19,142584,101346,77513,23833,30.7
2023-08-20,143332,100227,76867,23360,30.4
2023-08-21,143332,102587,91334,11253,12.3
2023-08-22,143332,104034,90322,13712,15.2
2023-08-23,143332,103456,87971,15485,17.6
2023-08-24,143332,102384,86561,15823,18.3
2023-08-25,143332,102355,82632,19723,23.9
2023-08-26,143332,98457,71966,26491,36.8
2023-08-27,143332,96857,71334,25523,35.8
2023-08-28,143332,102236,81578,20658,25.3
2023-08-29,143332,102207,83947,18260,21.8
2023-08-30,143401,101752,81190,20562,25.3
2023-08-31,143401,101698,77880,23818,30.6
2023-09-01,143401,100172,76397,23775,31.1
2023-09-02,143401,97506,68954,28552,41.4
2023-09-03,143401,98099,70303,27796,39.5
2023-09-04,143401,99186,85567,13619,15.9
2023-09-05,143401,99391,85682,13709,16.0
2023-09-06,143429,98686,84181,14505,17.2
2023-09-07,143429,98334,81665,16669,20.4
2023-09-08,143429,98050,78754,19296,24.5
2023-09-09,143429,94923,69152,25771,37.3
2023-09-10,143429,95818,68207,27611,40.5
2023-09-11,143429,97469,81913,15556,19.0
2023-09-12,143429,96217,82478,13739,16.7
2023-09-13,143460,94349,81364,12985,16.0
2023-09-14,143460,94930,80149,14781,18.4
2023-09-15,143460,94430,78139,16291,20.8
2023-09-16,143460,89463,69043,20420,29.6
2023-09-17,143460,92366,67762,24604,36.3
2023-09-18,143460,94611,79866,14745,18.5
2023-09-19,143460,91780,79704,12076,15.2
2023-09-20,143481,91763,79940,11823,14.8
2023-09-21,143481,92647,74465,18182,24.4
2023-09-22,143481,92123,71935,20188,28.1
2023-09-23,143481,88758,63395,25363,40.0
2023-09-24,143481,87899,61853,26046,42.1
2023-09-25,143481,90962,74249,16713,22.5
2023-09-26,143481,89883,74562,15321,20.5
2023-09-27,143486,91105,71537,19568,27.4
2023-09-28,143486,92297,56740,35557,62.7
2023-09-29,143486,89759,52425,37334,71.2
2023-09-30,143486,87107,54122,32985,60.9
2023-10-01,143486,88085,54323,33762,62.2
2023-10-02,143486,89665,57484,32181,56.0
2023-10-03,143486,88991,61368,27623,45.0
2023-10-04,143486,87361,70315,17046,24.2
2023-10-05,143486,88648,68749,19899,28.9
2023-10-06,143486,89340,68442,20898,30.5
2023-10-07,143486,88103,60894,27209,44.7
2023-10-08,143486,87772,58651,29121,49.7
2023-10-09,143486,86123,63732,22391,35.1
2023-10-10,143486,85494,70604,14890,21.1
2023-10-11,143486,84960,70443,14517,20.6
2023-10-12,143559,84165,70840,13325,18.8
2023-10-13,143559,84971,69448,15523,22.4
2023-10-14,143559,82270,60838,21432,35.2
2023-10-15,143559,83060,59651,23409,39.2
2023-10-16,143559,85263,69274,15989,23.1
2023-10-17,143559,84574,69960,14614,20.9
2023-10-18,143712,86240,69700,16540,23.7
2023-10-19,143712,85738,70985,14753,20.8
2023-10-20,143712,87249,67722,19527,28.8
2023-10-21,143712,83506,59888,23618,39.4
2023-10-22,143712,85357,58718,26639,45.4
2023-10-23,143712,83397,69638,13759,19.8
2023-10-24,143712,84248,70197,14051,20.0
2023-10-25,143731,83979,69653,14326,20.6
2023-10-26,143731,83740,70646,13094,18.5
2023-10-27,143731,84240,68296,15944,23.3
2023-10-28,143731,81318,59753,21565,36.1
2023-10-29,143731,82674,58684,23990,40.9
2023-10-30,143731,82961,69602,13359,19.2
2023-10-31,143731,84749,69878,14871,21.3
2023-11-01,143770,84681,69845,14836,21.2
2023-11-02,143770,86411,70489,15922,22.6
2023-11-03,143770,86921,69323,17598,25.4
2023-11-04,143770,86600,61037,25563,41.9
2023-11-05,143770,84474,60309,24165,40.1
2023-11-06,143770,85794,69757,16037,23.0
2023-11-07,143770,88748,70456,18292,26.0
2023-11-08,143802,88768,68456,20312,29.7
2023-11-09,143802,88466,69833,18633,26.7
2023-11-10,143802,90043,70206,19837,28.3
2023-11-11,143802,90025,63124,26901,42.6
2023-11-12,143802,90094,63156,26938,42.7
2023-11-13,143802,90613,75186,15427,20.5
2023-11-14,143802,89441,74305,15136,20.4
2023-11-15,143978,89641,73401,16240,22.1
2023-11-16,143978,89652,78815,10837,13.7
2023-11-17,143978,90313,76618,13695,17.9
2023-11-18,143978,91879,66148,25731,38.9
2023-11-19,143978,91299,62598,28701,45.8
2023-11-20,143978,92492,75162,17330,23.1
2023-11-21,143978,91666,74025,17641,23.8
2023-11-22,144336,92695,73266,19429,26.5
2023-11-23,144336,92817,72557,20260,27.9
2023-11-24,144336,97329,76598,20731,27.1
2023-11-25,144336,91812,66540,25272,38.0
2023-11-26,144336,90868,63720,27148,42.6
2023-11-27,144026,93206,79861,13345,16.7
2023-11-28,144026,96172,78894,17278,21.9
2023-11-29,144063,96664,81146,15518,19.1
2023-11-30,144063,96366,82716,13650,16.5
2023-12-01,144063,99572,81228,18344,22.6
2023-12-02,144063,96616,66924,29692,44.4
2023-12-03,144063,97827,65368,32459,49.7
2023-12-04,144063,99020,79599,19421,24.4
2023-12-05,144063,97325,78441,18884,24.1
2023-12-06,144070,99399,79102,20297,25.7
2023-12-07,144070,100157,77237,22920,29.7
2023-12-08,144070,99956,75245,24711,32.8
2023-12-09,144070,97556,62483,35073,56.1
2023-12-10,144070,96107,61067,35040,57.4
2023-12-11,144070,100669,76893,23776,30.9
2023-12-12,144070,100804,76995,23809,30.9
2023-12-13,144200,101145,75581,25564,33.8
2023-12-14,144200,101310,77896,23414,30.1
2023-12-15,144200,99963,78513,21450,27.3
2023-12-16,144200,99891,70383,29508,41.9
2023-12-17,144200,99119,70703,28416,40.2
2023-12-18,144200,103366,88869,14497,16.3
2023-12-19,144200,101928,88580,13348,15.1
2023-12-20,144381,103834,89230,14604,16.4
2023-12-21,144381,105213,91556,13657,14.9
2023-12-22,144381,104466,91391,13075,14.3
2023-12-23,144381,103207,73369,29838,40.7
2023-12-24,144381,102110,68643,33467,48.8
2023-12-25,144381,103217,71050,32167,45.3
2023-12-26,144381,102816,84106,18710,22.2
2023-12-27,144381,103064,82383,20681,25.1
2023-12-28,144381,102810,81745,21065,25.8
2023-12-29,144415,103693,78244,25449,32.5
2023-12-30,144415,102366,66025,36341,55.0
2023-12-31,144415,102709,63589,39120,61.5
2024-01-01,144415,101990,63132,38858,61.6
2024-01-02,144415,103419,80460,22959,28.5
2024-01-03,144415,101197,83422,17775,21.3
2024-01-04,144421,101701,81728,19973,24.4
2024-01-05,144421,101519,80632,20887,25.9
2024-01-06,144421,99930,67965,31965,47.0
2024-01-07,144421,103720,69798,33922,48.6
2024-01-08,144421,105598,84150,21448,25.5
2024-01-09,144421,103910,88214,15696,17.8
2024-01-10,144426,105583,85081,20502,24.1
2024-01-11,144426,103418,84185,19233,22.8
2024-01-12,144426,102931,80506,22425,27.9
2024-01-13,144426,98104,68211,29893,43.8
2024-01-14,144426,102984,66854,36130,54.0
2024-01-15,144426,105880,81436,24444,30.0
2024-01-16,144426,104133,83487,20646,24.7
2024-01-17,144640,103539,86162,17377,20.2
2024-01-18,144640,102314,82978,19336,23.3
2024-01-19,144640,101298,81003,20295,25.1
2024-01-20,144640,97708,69500,28208,40.6
2024-01-21,144640,99278,66867,32411,48.5
2024-01-22,144640,104312,86746,17566,20.2
2024-01-23,144640,104997,89231,15766,17.7
2024-01-24,144652,104666,88055,16611,18.9
2024-01-25,144652,104370,86788,17582,20.3
2024-01-26,144652,102593,84354,18239,21.6
2024-01-27,144652,100226,69125,31101,45.0
2024-01-28,144652,100740,67741,32999,48.7
2024-01-29,144652,101454,82039,19415,23.7
2024-01-30,144652,100814,82692,18122,21.9
2024-01-31,144746,99286,80671,18615,23.1
2024-02-01,144746,97420,81677,15743,19.3
2024-02-02,144746,99377,79921,19456,24.3
2024-02-03,144746,96458,66832,29626,44.3
2024-02-04,144746,98483,64807,33676,52.0
2024-02-05,144746,97905,82573,15332,18.6
2024-02-06,144746,97363,83641,13722,16.4
2024-02-07,144765,97216,79115,18101,22.9
2024-02-08,144765,101029,77521,23508,30.3
2024-02-09,144765,98759,62755,36004,57.4
2024-02-10,144765,98681,57179,41502,72.6
2024-02-11,144765,100590,58509,42081,71.9
2024-02-12,144765,98537,61340,37197,60.6
2024-02-13,144765,99200,71718,27482,38.3
2024-02-14,144765,99406,75951,23455,30.9
2024-02-15,144779,99252,78957,20295,25.7
2024-02-16,144779,98981,75965,23016,30.3
2024-02-17,144779,99297,64340,34957,54.3
2024-02-18,144779,98249,63128,35121,55.6
2024-02-19,144779,100165,76849,23316,30.3
2024-02-20,144779,100078,79989,20089,25.1
2024-02-21,144983,101952,81790,20162,24.7
2024-02-22,144983,101921,84093,17828,21.2
2024-02-23,144983,102637,81368,21269,26.1
2024-02-24,144983,99383,66189,33194,50.2
2024-02-25,144983,99547,63998,35549,55.5
2024-02-26,144983,97595,74935,22660,30.2
2024-02-27,144983,99023,75933,23090,30.4
2024-02-28,145013,98589,74394,24195,32.5
2024-02-29,145013,98139,79171,18968,24.0
2024-03-01,145013,98086,70870,27216,38.4
2024-03-02,145013,97767,66510,31257,47.0
2024-03-03,145013,94824,64502,30322,47.0
2024-03-04,145013,97561,76456,21105,27.6
2024-03-05,145013,95500,81691,13809,16.9
2024-03-06,145016,94421,75397,19024,25.2
2024-03-07,145016,94616,77363,17253,22.3
2024-03-08,145016,94887,74464,20423,27.4
2024-03-09,145016,86562,65322,21240,32.5
2024-03-10,145016,85565,63464,22101,34.8
2024-03-11,145016,92202,74908,17294,23.1
2024-03-12,145016,91404,78213,13191,16.9
2024-03-13,145008,87647,73868,13779,18.7
2024-03-14,145008,89106,73172,15934,21.8
2024-03-15,145008,89233,70500,18733,26.6
2024-03-16,145008,83600,62121,21479,34.6
2024-03-17,145008,82789,61659,21130,34.3
2024-03-18,145008,88397,71342,17055,23.9
2024-03-19,145008,88935,73424,15511,21.1
2024-03-20,145162,87216,72438,14778,20.4
2024-03-21,145162,87429,72439,14990,20.7
2024-03-22,145162,84736,70498,14238,20.2
2024-03-23,145162,82122,60972,21150,34.7
2024-03-24,145162,81739,59839,21900,36.6
2024-03-25,145162,86170,72997,13173,18.0
2024-03-26,145162,87608,74182,13426,18.1
2024-03-27,145175,87771,69829,17942,25.7
2024-03-28,145175,86289,75842,10447,13.8
2024-03-29,145175,88279,69967,18312,26.2
2024-03-30,145175,83827,60199,23628,39.2
2024-03-31,145175,80988,58369,22619,38.8
2024-04-01,145175,86473,67349,19124,28.4
2024-04-02,145175,85029,67742,17287,25.5
2024-04-03,145191,83155,71199,11956,16.8
2024-04-04,145191,84160,68151,16009,23.5
2024-04-05,146634,87037,65933,21104,32.0
2024-04-06,146634,85887,58937,26950,45.7
2024-04-07,146634,85279,57502,27777,48.3
2024-04-08,146634,86350,67383,18967,28.1
2024-04-09,146634,89521,66950,22571,33.7
2024-04-10,146634,89416,62161,27255,43.8
2024-04-11,146634,87821,66663,21158,31.7
2024-04-12,146634,87005,64816,22189,34.2
2024-04-13,146634,84897,58314,26583,45.6
2024-04-14,146634,84810,58115,26695,45.9
2024-04-15,146634,86527,68634,17893,26.1
2024-04-16,146634,86462,67321,19141,28.4
2024-04-17,146648,86950,66182,20768,31.4
2024-04-18,146648,86846,66740,20106,30.1
2024-04-19,146648,85986,65136,20850,32.0
2024-04-20,146648,81025,59338,21687,36.5
2024-04-21,146648,80579,58279,22300,38.3
2024-04-22,146648,81352,66727,14625,21.9
2024-04-23,146648,83431,66991,16440,24.5
2024-04-24,146804,84100,66215,17885,27.0
2024-04-25,146804,84577,66552,18025,27.1
2024-04-26,146804,82938,65026,17912,27.5
2024-04-27,146804,82586,57999,24587,42.4
2024-04-28,146804,82956,58003,24953,43.0
2024-04-29,146804,82388,67228,15160,22.6
2024-04-30,146804,84692,66065,18627,28.2
2024-05-01,146769,84183,60711,23472,38.7
2024-05-02,146769,85106,66858,18248,27.3
2024-05-03,146769,83940,65403,18537,28.3
2024-05-04,146769,80783,57871,22912,39.6
2024-05-05,146769,79862,57151,22711,39.7
2024-05-06,146769,79868,60134,19734,32.8
2024-05-07,146769,82553,67765,14788,21.8
2024-05-08,146769,83781,65047,18734,28.8
2024-05-09,146781,84188,66481,17707,26.6
2024-05-10,146781,84637,65342,19295,29.5
2024-05-11,146781,81666,60042,21624,36.0
2024-05-12,146781,83874,57019,26855,47.1
2024-05-13,146781,82781,66062,16719,25.3
2024-05-14,146781,82838,66155,16683,25.2
2024-05-15,146781,84159,61854,22305,36.1
2024-05-16,146781,84251,65411,18840,28.8
2024-05-17,147824,84810,64407,20403,31.7
2024-05-18,147824,80001,58755,21246,36.2
2024-05-19,147824,81405,58903,22502,38.2
2024-05-20,147824,81523,68764,12759,18.6
2024-05-21,147824,81608,69074,12534,18.1
2024-05-22,147999,82015,68837,13178,19.1
2024-05-23,147999,82585,69899,12686,18.1
2024-05-24,147999,83976,67481,16495,24.4
2024-05-25,147999,81428,59700,21728,36.4
2024-05-26,147999,81935,59436,22499,37.9
2024-05-27,147999,81417,67126,14291,21.3
2024-05-28,147999,80711,68694,12017,17.5
2024-05-29,148010,81388,68823,12565,18.3
2024-05-30,148010,81392,69571,11821,17.0
2024-05-31,148010,81185,66428,14757,22.2
2024-06-01,148010,80669,59085,21584,36.5
2024-06-02,148010,80914,58661,22253,37.9
2024-06-03,148010,83320,68493,14827,21.6
2024-06-04,148010,82534,69279,13255,19.1
2024-06-05,148013,82374,69421,12953,18.7
2024-06-06,148013,82299,65329,16970,26.0
2024-06-07,148013,81430,67558,13872,20.5
2024-06-08,148013,78011,60509,17502,28.9
2024-06-09,148013,80290,60934,19356,31.8
2024-06-10,148013,83154,72134,11020,15.3
2024-06-11,148013,85597,74244,11353,15.3
2024-06-12,148084,84347,74251,10096,13.6
2024-06-13,148084,85470,76144,9326,12.2
2024-06-14,148084,86901,75619,11282,14.9
2024-06-15,148084,83230,66114,17116,25.9
2024-06-16,148084,81459,63577,17882,28.1
2024-06-17,148084,86828,73958,12870,17.4
2024-06-18,148084,87447,76826,10621,13.8
2024-06-19,148089,89170,80077,9093,11.4
2024-06-20,148089,89378,79731,9647,12.1
2024-06-21,148089,91016,77749,13267,17.1
2024-06-22,148089,84914,68355,16559,24.2
2024-06-23,148089,86778,66868,19910,29.8
2024-06-24,148089,91515,76628,14887,19.4
2024-06-25,148089,91673,73022,18651,25.5
2024-06-26,148089,93282,74719,18563,24.8
2024-06-27,148089,92041,76144,15897,20.9
2024-06-28,148089,89229,74741,14488,19.4
2024-06-29,148089,88692,68360,20332,29.7
2024-06-30,148709,92841,65856,26985,41.0
2024-07-01,148709,95058,78373,16685,21.3
2024-07-02,148709,95711,79801,15910,19.9
2024-07-03,148897,95509,77555,17954,23.2
2024-07-04,148897,95812,81970,13842,16.9
2024-07-05,148897,95500,77102,18398,23.9
2024-07-06,148897,93120,72015,21105,29.3
2024-07-07,148897,93120,70129,22991,32.8
2024-07-08,148897,96391,83021,13370,16.1
2024-07-09,148897,97233,82246,14987,18.2
2024-07-10,148912,97872,80964,16908,20.9
2024-07-11,148912,98172,79983,18189,22.7
2024-07-12,148912,97623,78463,19160,24.4
2024-07-13,148912,96929,71353,25576,35.8
2024-07-14,148912,95453,69336,26117,37.7
2024-07-15,148912,100094,82759,17335,20.9
2024-07-16,148912,98716,83678,15038,18.0
2024-07-17,148917,99597,84204,15393,18.3
2024-07-18,148917,98615,84567,14048,16.6
2024-07-19,148917,96173,82174,13999,17.0
2024-07-20,148917,98911,74657,24254,32.5
2024-07-21,148917,98147,74740,23407,31.3
2024-07-22,148917,100373,86921,13452,15.5
2024-07-23,148917,99079,87645,11434,13.0
2024-07-24,148932,100266,87552,12714,14.5
2024-07-25,148932,99162,90254,8908,9.9
2024-07-26,148932,99785,88660,11125,12.5
2024-07-27,148932,94695,77483,17212,22.2
2024-07-27,148932,94695,77483,17212,22.2
2024-07-28,148932,95923,76431,19492,25.5
2024-07-28,148932,95923,76431,19492,25.5
2024-07-29,148932,96042,82616,13426,16.3
2024-07-29,148932,96042,82616,13426,16.3
2024-07-30,148932,96704,84530,12174,14.4
2024-07-30,148932,96704,84530,12174,14.4
2024-07-31,149151,96018,84794,11224,13.2
2024-07-31,149151,96018,84794,11224,13.2
2024-08-01,149151,96211,85215,10996,12.9
2024-08-01,149151,96211,85215,10996,12.9
2024-08-02,149151,99899,85301,14598,17.1
2024-08-02,149151,99899,85301,14598,17.1
2024-08-03,149151,96672,80942,15730,19.4
2024-08-03,149151,96672,80942,15730,19.4
2024-08-04,149151,97228,81926,15302,18.7
2024-08-05,149151,102310,93841,8469,9.0
2024-08-06,149151,101916,91799,10117,11.0
2024-08-07,149177,102219,92326,9893,10.7
2024-08-08,149177,102596,90615,11981,13.2
2024-08-09,149177,103571,89962,13609,15.1
2024-08-10,149177,99138,81106,18032,22.2
2024-08-11,149177,99610,81183,18427,22.7
2024-08-12,149177,102844,94489,8355,8.8
2024-08-13,149177,104764,94639,10125,10.7
2024-08-14,149179,103319,93508,9811,10.5
2024-08-15,149179,100113,85140,14973,17.6
2024-08-16,149179,101278,90358,10920,12.1
2024-08-17,149179,98079,80794,17285,21.4
2024-08-18,149179,99544,80336,19208,23.9
2024-08-19,149179,104640,95611,9029,9.4
2024-08-20,149179,105360,97115,8245,8.5
2024-08-21,149185,105236,92623,12613,13.6
2024-08-22,149185,104705,93224,11481,12.3
2024-08-23,149185,102426,90221,12205,13.5
