,설비용량(MW),공급능력(MW),최대전력(MW),공급예비력(MW),공급예비율(%),Date
2781,105866,89861,59234,30627,51.7,2017-01-01
2780,105866,92573,72901,19672,27.0,2017-01-02
2779,105866,94223,75471,18752,24.8,2017-01-03
2778,105866,92353,75778,16575,21.9,2017-01-04
2777,105866,92474,76304,16170,21.2,2017-01-05
2776,105866,92841,74060,18781,25.4,2017-01-06
2775,105866,90470,64879,25591,39.4,2017-01-07
2774,105866,90644,59058,31586,53.5,2017-01-08
2773,105866,92252,75090,17162,22.9,2017-01-09
2772,105866,93039,76690,16349,21.3,2017-01-10
2771,105866,94862,78898,15964,20.2,2017-01-11
2770,105866,94338,78403,15935,20.3,2017-01-12
2769,105866,94912,80079,14833,18.5,2017-01-13
2768,105866,92828,69894,22934,32.8,2017-01-14
2767,105866,91004,66021,24983,37.8,2017-01-15
2766,105866,93313,80790,12523,15.5,2017-01-16
2765,105866,94280,81681,12599,15.4,2017-01-17
2764,106238,95091,79959,15132,18.9,2017-01-18
2763,106238,94146,80171,13975,17.4,2017-01-19
2762,106238,94284,81765,12519,15.3,2017-01-20
2761,106238,90927,71225,19702,27.7,2017-01-21
2760,106238,91965,66749,25216,37.8,2017-01-22
2759,106238,95443,83657,11786,14.1,2017-01-23
2758,106238,96526,82884,13642,16.5,2017-01-24
2757,106238,95823,81686,14137,17.3,2017-01-25
2756,106238,95631,78670,16961,21.6,2017-01-26
2755,106238,91078,62908,28170,44.8,2017-01-27
2754,106238,89072,56442,32630,57.8,2017-01-28
2753,106238,89100,57667,31433,54.5,2017-01-29
2752,106238,91686,62634,29052,46.4,2017-01-30
2751,106238,94937,77034,17903,23.2,2017-01-31
2750,107098,95220,80173,15047,18.8,2017-02-01
2749,107098,96341,80243,16098,20.1,2017-02-02
2748,107098,96289,78232,18057,23.1,2017-02-03
2747,107098,94172,67533,26639,39.4,2017-02-04
2746,107098,94991,62577,32414,51.8,2017-02-05
2745,107098,96366,78251,18115,23.1,2017-02-06
2744,107098,97305,80163,17142,21.4,2017-02-07
2743,107098,96980,79274,17706,22.3,2017-02-08
2742,107098,97002,80002,17000,21.2,2017-02-09
2741,107098,95916,81268,14648,18.0,2017-02-10
2740,107098,92955,69363,23592,34.0,2017-02-11
2739,107098,93782,64047,29735,46.4,2017-02-12
2738,107098,96343,79050,17293,21.9,2017-02-13
2737,107098,96561,78279,18282,23.4,2017-02-14
2736,107098,96403,77770,18633,24.0,2017-02-15
2735,107098,96295,75604,20691,27.4,2017-02-16
2734,107098,96207,74358,21849,29.4,2017-02-17
2733,107098,90042,65574,24468,37.3,2017-02-18
2732,107098,89643,61553,28090,45.6,2017-02-19
2731,107098,93928,76063,17865,23.5,2017-02-20
2730,107098,93347,77149,16198,21.0,2017-02-21
2729,107098,93689,78523,15166,19.3,2017-02-22
2728,107098,93526,75909,17617,23.2,2017-02-23
2727,107098,92732,75970,16762,22.1,2017-02-24
2726,107098,91811,64596,27215,42.1,2017-02-25
2725,107098,91375,60444,30931,51.2,2017-02-26
2724,107098,93171,73564,19607,26.7,2017-02-27
2723,107098,92437,73617,18820,25.6,2017-02-28
2722,107098,92104,64523,27581,42.7,2017-03-01
2721,107098,92979,75921,17058,22.5,2017-03-02
2720,107098,93749,74262,19487,26.2,2017-03-03
2719,107098,91420,62651,28769,45.9,2017-03-04
2718,107098,91770,58780,32990,56.1,2017-03-05
2717,107098,94148,73396,20752,28.3,2017-03-06
2716,107098,93840,76756,17084,22.3,2017-03-07
2715,107703,92902,76634,16268,21.2,2017-03-08
2714,107703,92807,74556,18251,24.5,2017-03-09
2713,107703,92047,73349,18698,25.5,2017-03-10
2712,107703,90228,62468,27760,44.4,2017-03-11
2711,107703,91063,57589,33474,58.1,2017-03-12
2710,107703,93327,70385,22942,32.6,2017-03-13
2709,107703,91119,70674,20445,28.9,2017-03-14
2708,107703,90591,71134,19457,27.4,2017-03-15
2707,107703,91482,70775,20707,29.3,2017-03-16
2706,108601,91839,70322,21517,30.6,2017-03-17
2705,108601,90013,61921,28092,45.4,2017-03-18
2704,108601,87910,56890,31020,54.5,2017-03-19
2703,108601,87922,69809,18113,25.9,2017-03-20
2702,108601,87503,68210,19293,28.3,2017-03-21
2701,108601,87657,70170,17487,24.9,2017-03-22
2700,108601,87672,69549,18123,26.1,2017-03-23
2699,108601,88072,69257,18815,27.2,2017-03-24
2698,108601,86606,61395,25211,41.1,2017-03-25
2697,108601,87877,57467,30410,52.9,2017-03-26
2696,108601,88323,70135,18188,25.9,2017-03-27
2695,109493,86241,70060,16181,23.1,2017-03-28
2694,109493,87117,69891,17226,24.6,2017-03-29
2693,109493,87994,67807,20187,29.8,2017-03-30
2692,109493,88725,68976,19749,28.6,2017-03-31
2691,110502,82935,59219,23716,40.0,2017-04-01
2690,110502,85311,56420,28891,51.2,2017-04-02
2689,110502,84021,65686,18335,27.9,2017-04-03
2688,110502,86064,65973,20091,30.5,2017-04-04
2687,110502,86046,68200,17846,26.2,2017-04-05
2686,110502,87916,69129,18787,27.2,2017-04-06
2685,110502,87253,65396,21857,33.4,2017-04-07
2684,110502,86383,56759,29624,52.2,2017-04-08
2683,110502,84126,54617,29509,54.0,2017-04-09
2682,110502,87013,63993,23020,36.0,2017-04-10
2681,110502,87343,65921,21422,32.5,2017-04-11
2680,110502,85970,64262,21708,33.8,2017-04-12
2679,110502,84544,64430,20114,31.2,2017-04-13
2678,110502,85529,64493,21036,32.6,2017-04-14
2677,110671,83099,55961,27138,48.5,2017-04-15
2676,110671,82735,54282,28453,52.4,2017-04-16
2675,110671,82855,66355,16500,24.9,2017-04-17
2674,110671,83724,65101,18623,28.6,2017-04-18
2673,110671,83051,62985,20066,31.9,2017-04-19
2672,110671,83682,65335,18347,28.1,2017-04-20
2671,110671,84048,63284,20764,32.8,2017-04-21
2670,110671,83523,56424,27099,48.0,2017-04-22
2669,110671,81850,54420,27430,50.4,2017-04-23
2668,110671,82873,63820,19053,29.9,2017-04-24
2667,110671,81209,64533,16676,25.8,2017-04-25
2666,110671,80871,63329,17542,27.7,2017-04-26
2665,110671,79714,63751,15963,25.0,2017-04-27
2664,110671,80659,62861,17798,28.3,2017-04-28
2663,110671,81130,55507,25623,46.2,2017-04-29
2662,110671,80635,54163,26472,48.9,2017-04-30
2661,110671,82501,56790,25711,45.3,2017-05-01
2660,110671,82331,62100,20231,32.6,2017-05-02
2659,110671,82942,58991,23951,40.6,2017-05-03
2658,110671,83056,60366,22690,37.6,2017-05-04
2657,110671,83028,56195,26833,47.7,2017-05-05
2656,110671,79430,53271,26159,49.1,2017-05-06
2655,111168,80272,53449,26823,50.2,2017-05-07
2654,111168,77697,63803,13894,21.8,2017-05-08
2653,111168,79013,61163,17850,29.2,2017-05-09
2652,111168,80821,65137,15684,24.1,2017-05-10
2651,111168,80138,65315,14823,22.7,2017-05-11
2650,111168,80398,66500,13898,20.9,2017-05-12
2649,111168,78407,57892,20515,35.4,2017-05-13
2648,111168,77523,54246,23277,42.9,2017-05-14
2647,111168,81620,64452,17168,26.6,2017-05-15
2646,111168,80844,64434,16410,25.5,2017-05-16
2645,111168,79301,65506,13795,21.1,2017-05-17
2644,111168,80633,66176,14457,21.8,2017-05-18
2643,111168,80693,66619,14074,21.1,2017-05-19
2642,111292,80072,58028,22044,38.0,2017-05-20
2641,111292,81065,55580,25485,45.9,2017-05-21
2640,111292,81274,67482,13792,20.4,2017-05-22
2639,111292,82751,67772,14979,22.1,2017-05-23
2638,111292,83178,67810,15368,22.7,2017-05-24
2637,111292,81835,67007,14828,22.1,2017-05-25
2636,111292,83009,64402,18607,28.9,2017-05-26
2635,111292,81212,56633,24579,43.4,2017-05-27
2634,111292,82527,55277,27250,49.3,2017-05-28
2633,111292,83014,69854,13160,18.8,2017-05-29
2632,111292,82497,69887,12610,18.0,2017-05-30
2631,111292,81665,69234,12431,18.0,2017-05-31
2630,111292,81837,68853,12984,18.9,2017-06-01
2629,111292,82221,65633,16588,25.3,2017-06-02
2628,111292,76968,56898,20070,35.3,2017-06-03
2627,111292,77623,54654,22969,42.0,2017-06-04
2626,111292,81483,65530,15953,24.3,2017-06-05
2625,111292,81083,61087,19996,32.7,2017-06-06
2624,111292,82683,67008,15675,23.4,2017-06-07
2623,111292,81647,66753,14894,22.3,2017-06-08
2622,111292,83707,67241,16466,24.5,2017-06-09
2621,111292,82165,58759,23406,39.8,2017-06-10
2620,111292,83161,55233,27928,50.6,2017-06-11
2619,111292,83421,66895,16526,24.7,2017-06-12
2618,112316,84907,68006,16901,24.9,2017-06-13
2617,112316,85205,68179,17026,25.0,2017-06-14
2616,112316,84747,70246,14501,20.6,2017-06-15
2615,112316,86941,71332,15609,21.9,2017-06-16
2614,112316,83591,61261,22330,36.5,2017-06-17
2613,112316,81885,57785,24100,41.7,2017-06-18
2612,111729,85006,72473,12533,17.3,2017-06-19
2611,111729,85132,73961,11171,15.1,2017-06-20
2610,112779,86441,73408,13033,17.8,2017-06-21
2609,112779,86466,73196,13270,18.1,2017-06-22
2608,112779,86724,75077,11647,15.5,2017-06-23
2607,113705,83428,63296,20132,31.8,2017-06-24
2606,113705,85323,58182,27141,46.6,2017-06-25
2605,113705,87820,73186,14634,20.0,2017-06-26
2604,113705,87531,73199,14332,19.6,2017-06-27
2603,113705,87698,74442,13256,17.8,2017-06-28
2602,113705,87585,74958,12627,16.8,2017-06-29
2601,113705,87888,75413,12475,16.5,2017-06-30
2600,113305,86424,64637,21787,33.7,2017-07-01
2599,113305,87819,61902,25917,41.9,2017-07-02
2598,113305,92113,77051,15062,19.5,2017-07-03
2597,113305,91290,78325,12965,16.6,2017-07-04
2596,113305,89667,78494,11173,14.2,2017-07-05
2595,113305,91939,80673,11266,14.0,2017-07-06
2594,113305,93549,78640,14909,19.0,2017-07-07
2593,113305,89545,68187,21358,31.3,2017-07-08
2592,113305,88021,64400,23621,36.7,2017-07-09
2591,113305,92732,78441,14291,18.2,2017-07-10
2590,113305,92247,79685,12562,15.8,2017-07-11
2589,113305,91477,80087,11390,14.2,2017-07-12
2588,113305,92621,81830,10791,13.2,2017-07-13
2587,113305,93437,83214,10223,12.3,2017-07-14
2586,113305,89847,69532,20315,29.2,2017-07-15
2585,113305,89317,65320,23997,36.7,2017-07-16
2584,113305,93900,81042,12858,15.9,2017-07-17
2583,113351,94706,80451,14255,17.7,2017-07-18
2582,113351,94157,82682,11475,13.9,2017-07-19
2581,113351,94712,84558,10154,12.0,2017-07-20
2580,113351,94987,84586,10401,12.3,2017-07-21
2579,113351,90733,75408,15325,20.3,2017-07-22
2578,113351,89993,68319,21674,31.7,2017-07-23
2577,113351,94461,82052,12409,15.1,2017-07-24
2576,113351,94780,83321,11459,13.8,2017-07-25
2575,113351,95163,80610,14553,18.1,2017-07-26
2574,113351,95140,79180,15960,20.2,2017-07-27
2573,113351,95482,78700,16782,21.3,2017-07-28
2572,113351,90645,66214,24431,36.9,2017-07-29
2571,113351,91077,63971,27106,42.4,2017-07-30
2570,113351,93121,69467,23654,34.1,2017-07-31
2569,113351,93092,71974,21118,29.3,2017-08-01
2568,113351,93550,73103,20447,28.0,2017-08-02
2567,113351,93031,74343,18688,25.1,2017-08-03
2566,113351,91769,76990,14779,19.2,2017-08-04
2565,113351,88265,72300,15965,22.1,2017-08-05
2564,113351,88398,70906,17492,24.7,2017-08-06
2563,113351,95125,84489,10636,12.6,2017-08-07
2562,113351,94804,83775,11029,13.2,2017-08-08
2561,113351,93714,80418,13296,16.5,2017-08-09
2560,113351,94592,79807,14785,18.5,2017-08-10
2559,113351,95564,80629,14935,18.5,2017-08-11
2558,114206,91506,69570,21936,31.5,2017-08-12
2557,114206,90404,61500,28904,47.0,2017-08-13
2556,114206,94832,72855,21977,30.2,2017-08-14
2555,114206,93361,67072,26289,39.2,2017-08-15
2554,114206,95468,75902,19566,25.8,2017-08-16
2553,114206,95799,77288,18511,24.0,2017-08-17
2552,114206,95321,77648,17673,22.8,2017-08-18
2551,114206,93359,67973,25386,37.3,2017-08-19
2550,114206,91390,62497,28893,46.2,2017-08-20
2549,114206,94942,79104,15838,20.0,2017-08-21
2548,114206,94813,80879,13934,17.2,2017-08-22
2547,114206,94851,83840,11011,13.1,2017-08-23
2546,114206,95345,83432,11913,14.3,2017-08-24
2545,114206,94808,79071,15737,19.9,2017-08-25
2544,114206,91577,63547,28030,44.1,2017-08-26
2543,114206,91074,59950,31124,51.9,2017-08-27
2542,114206,95752,75454,20298,26.9,2017-08-28
2541,114206,96582,71234,25348,35.6,2017-08-29
2540,114206,96569,68797,27772,40.4,2017-08-30
2539,114206,95847,70229,25618,36.5,2017-08-31
2538,114206,94100,70931,23169,32.7,2017-09-01
2537,114206,91533,61591,29942,48.6,2017-09-02
2536,114206,91678,58814,32864,55.9,2017-09-03
2535,114206,92846,72688,20158,27.7,2017-09-04
2534,114206,94499,71944,22555,31.4,2017-09-05
2533,114206,95006,71880,23126,32.2,2017-09-06
2532,114206,94511,71699,22812,31.8,2017-09-07
2531,114206,93909,73038,20871,28.6,2017-09-08
2530,114206,89779,64087,25692,40.1,2017-09-09
2529,114206,88745,59509,29236,49.1,2017-09-10
2528,114206,92651,70946,21705,30.6,2017-09-11
2527,114206,92313,72229,20084,27.8,2017-09-12
2526,114206,93014,70373,22641,32.2,2017-09-13
2525,114206,94191,71099,23092,32.5,2017-09-14
2524,114206,92279,69521,22758,32.7,2017-09-15
2523,114206,88214,60602,27612,45.6,2017-09-16
2522,114206,87659,58088,29571,50.9,2017-09-17
2521,114206,92551,71299,21252,29.8,2017-09-18
2520,114206,92665,73115,19550,26.7,2017-09-19
2519,114206,92456,68979,23477,34.0,2017-09-20
2518,114206,91777,69362,22415,32.3,2017-09-21
2517,114206,91816,69987,21829,31.2,2017-09-22
2516,114206,89309,61791,27518,44.5,2017-09-23
2515,114206,89652,59195,30457,51.5,2017-09-24
2514,114206,91820,72798,19022,26.1,2017-09-25
2513,114206,92144,72947,19197,26.3,2017-09-26
2512,114206,90947,70978,19969,28.1,2017-09-27
2511,114206,91397,68330,23067,33.8,2017-09-28
2510,115249,93193,64707,28486,44.0,2017-09-29
2509,115249,90193,58351,31842,54.6,2017-09-30
2508,115249,89766,56530,33236,58.8,2017-10-01
2507,115249,90276,55447,34829,62.8,2017-10-02
2506,115249,89682,48934,40748,83.3,2017-10-03
2505,115249,90044,46004,44040,95.7,2017-10-04
2504,115249,86206,48919,37287,76.2,2017-10-05
2503,115249,85300,52312,32988,63.1,2017-10-06
2502,115249,84897,54716,30181,55.2,2017-10-07
2501,115249,84897,56165,28732,51.2,2017-10-08
2500,115249,88352,62781,25571,40.7,2017-10-09
2499,115249,88736,70113,18623,26.6,2017-10-10
2498,115249,89078,68423,20655,30.2,2017-10-11
2497,115249,89422,67158,22264,33.2,2017-10-12
2496,115249,87471,66400,21071,31.7,2017-10-13
2495,115249,85314,58848,26466,45.0,2017-10-14
2494,115249,83035,56499,26536,47.0,2017-10-15
2493,115900,84250,67783,16467,24.3,2017-10-16
2492,115900,85546,68021,17525,25.8,2017-10-17
2491,115900,86343,67701,18642,27.5,2017-10-18
2490,115900,86417,68224,18193,26.7,2017-10-19
2489,115900,87499,66981,20518,30.6,2017-10-20
2488,115900,86319,58896,27423,46.6,2017-10-21
2487,115900,88162,56047,32115,57.3,2017-10-22
2486,115900,87936,67501,20435,30.3,2017-10-23
2485,115900,86397,67971,18426,27.1,2017-10-24
2484,115900,87495,67111,20384,30.4,2017-10-25
2483,115900,85521,67751,17770,26.2,2017-10-26
2482,115900,86125,66589,19536,29.3,2017-10-27
2481,115900,83421,58510,24911,42.6,2017-10-28
2480,115900,84929,56295,28634,50.9,2017-10-29
2479,115900,87521,68265,19256,28.2,2017-10-30
2478,115900,87081,67675,19406,28.7,2017-10-31
2477,115900,85425,66262,19163,28.9,2017-11-01
2476,115900,86093,67063,19030,28.4,2017-11-02
2475,115900,85673,66731,18942,28.4,2017-11-03
2474,115900,83556,58933,24623,41.8,2017-11-04
2473,115900,85517,56809,28708,50.5,2017-11-05
2472,115900,88088,68148,19940,29.3,2017-11-06
2471,115900,87229,67851,19378,28.6,2017-11-07
2470,115900,88117,66862,21255,31.8,2017-11-08
2469,115900,88234,67500,20734,30.7,2017-11-09
2468,115900,85972,68299,17673,25.9,2017-11-10
2467,115900,85993,59621,26372,44.2,2017-11-11
2466,115900,87050,57618,29432,51.1,2017-11-12
2465,115900,87918,70689,17229,24.4,2017-11-13
2464,115900,87731,70501,17230,24.4,2017-11-14
2463,115900,89682,71978,17704,24.6,2017-11-15
2462,115900,91217,72971,18246,25.0,2017-11-16
2461,115900,92398,74345,18053,24.3,2017-11-17
2460,115900,89274,64400,24874,38.6,2017-11-18
2459,115900,90095,61715,28380,46.0,2017-11-19
2458,115900,91442,76794,14648,19.1,2017-11-20
2457,115900,90278,77327,12951,16.7,2017-11-21
2456,115900,91187,77349,13838,17.9,2017-11-22
2455,116278,92783,77003,15780,20.5,2017-11-23
2454,116278,92807,77605,15202,19.6,2017-11-24
2453,116278,86553,65980,20573,31.2,2017-11-25
2452,116278,88497,61257,27240,44.5,2017-11-26
2451,116278,92492,76318,16174,21.2,2017-11-27
2450,116278,93583,76519,17064,22.3,2017-11-28
2449,116278,93866,74378,19488,26.2,2017-11-29
2448,116278,92483,77048,15435,20.0,2017-11-30
2447,116278,92783,77668,15115,19.5,2017-12-01
2446,116278,92906,66179,26727,40.4,2017-12-02
2445,116278,91700,61218,30482,49.8,2017-12-03
2444,116657,92064,79221,12843,16.2,2017-12-04
2443,116657,91914,80788,11126,13.8,2017-12-05
2442,116657,91812,80911,10901,13.5,2017-12-06
2441,116657,91572,80127,11445,14.3,2017-12-07
2440,116657,92551,81361,11190,13.8,2017-12-08
2439,116657,88449,68767,19682,28.6,2017-12-09
2438,116657,90784,64000,26784,41.9,2017-12-10
2437,116657,95498,83927,11571,13.8,2017-12-11
2436,116657,96095,85133,10962,12.9,2017-12-12
2435,116657,97418,84012,13406,16.0,2017-12-13
2434,116657,96778,84968,11810,13.9,2017-12-14
2433,116657,96407,84115,12292,14.6,2017-12-15
2432,116657,92603,70890,21713,30.6,2017-12-16
2431,116657,95078,66825,28253,42.3,2017-12-17
2430,116657,96581,84640,11941,14.1,2017-12-18
2429,116657,97171,83873,13298,15.9,2017-12-19
2428,116657,97205,83664,13541,16.2,2017-12-20
2427,116657,94978,83450,11528,13.8,2017-12-21
2426,116657,95844,81852,13992,17.1,2017-12-22
2425,116657,93545,67211,26334,39.2,2017-12-23
2424,116657,94461,63302,31159,49.2,2017-12-24
2423,116657,96082,66498,29584,44.5,2017-12-25
2422,116657,97780,81374,16406,20.2,2017-12-26
2421,116657,98281,83589,14692,17.6,2017-12-27
2420,116908,97955,83478,14477,17.3,2017-12-28
2419,116908,97981,78857,19124,24.3,2017-12-29
2418,116908,95536,64779,30757,47.5,2017-12-30
2417,116908,96958,62446,34512,55.3,2017-12-31
2416,116428,97398,62145,35253,56.7,2018-01-01
2415,116428,98255,79331,18924,23.9,2018-01-02
2414,116428,98830,81596,17234,21.1,2018-01-03
2413,116428,98111,84027,14084,16.8,2018-01-04
2412,116428,98798,82551,16247,19.7,2018-01-05
2411,116428,94963,68502,26461,38.6,2018-01-06
2410,116428,94608,64428,30180,46.8,2018-01-07
2409,116428,98246,83012,15234,18.4,2018-01-08
2408,116428,98786,84021,14765,17.6,2018-01-09
2407,116428,99146,84978,14168,16.7,2018-01-10
2406,116428,98986,85612,13374,15.6,2018-01-11
2405,116428,98988,85497,13491,15.8,2018-01-12
2404,116428,93735,72843,20892,28.7,2018-01-13
2403,116428,94636,66286,28350,42.8,2018-01-14
2402,116428,95204,80495,14709,18.3,2018-01-15
2401,116428,96018,82564,13454,16.3,2018-01-16
2400,116428,95696,80766,14930,18.5,2018-01-17
2399,116428,96327,79748,16579,20.8,2018-01-18
2398,116428,96839,79633,17206,21.6,2018-01-19
2397,116428,92979,67813,25166,37.1,2018-01-20
2396,116428,94866,63917,30949,48.4,2018-01-21
2395,116428,97485,80609,16876,20.9,2018-01-22
2394,116428,98318,85442,12876,15.1,2018-01-23
2393,116428,98511,86277,12234,14.2,2018-01-24
2392,116428,99147,87247,11900,13.6,2018-01-25
2391,116428,99232,87063,12169,14.0,2018-01-26
2390,116428,97365,74418,22947,30.8,2018-01-27
2389,116428,95051,68496,26555,38.8,2018-01-28
2388,116428,99605,86561,13044,15.1,2018-01-29
2387,116428,99203,86754,12449,14.3,2018-01-30
2386,116428,99706,85260,14446,16.9,2018-01-31
2385,116428,100239,83904,16335,19.5,2018-02-01
2384,116428,100029,84653,15376,18.2,2018-02-02
2383,116428,96130,72685,23445,32.3,2018-02-03
2382,116428,95710,69711,25999,37.3,2018-02-04
2381,116428,100724,87623,13101,15.0,2018-02-05
2380,116428,101148,88238,12910,14.6,2018-02-06
2379,116428,101050,87513,13537,15.5,2018-02-07
2378,116428,99882,87277,12605,14.4,2018-02-08
2377,116428,100220,84660,15560,18.4,2018-02-09
2376,116428,95524,71240,24284,34.1,2018-02-10
2375,116428,96307,68538,27769,40.5,2018-02-11
2374,116428,99856,86637,13219,15.3,2018-02-12
2373,116428,99516,83809,15707,18.7,2018-02-13
2372,116428,98260,77843,20417,26.2,2018-02-14
2371,116428,96010,63182,32828,52.0,2018-02-15
2370,116428,91926,57733,34193,59.2,2018-02-16
2369,116428,91080,59867,31213,52.1,2018-02-17
2368,116428,92300,61172,31128,50.9,2018-02-18
2367,116428,97460,76438,21022,27.5,2018-02-19
2366,116428,96945,79383,17562,22.1,2018-02-20
2365,116428,97072,80128,16944,21.1,2018-02-21
2364,116428,97291,79662,17629,22.1,2018-02-22
2363,116428,97115,79069,18046,22.8,2018-02-23
2362,116428,91253,66278,24975,37.7,2018-02-24
2361,116428,94215,63005,31210,49.5,2018-02-25
2360,116428,96486,76656,19830,25.9,2018-02-26
2359,116428,96476,77133,19343,25.1,2018-02-27
2358,116428,96527,78122,18405,23.6,2018-02-28
2357,116428,93988,68728,25260,36.8,2018-03-01
2356,116428,93668,76433,17235,22.5,2018-03-02
2355,116428,90231,64571,25660,39.7,2018-03-03
2354,116428,88452,58887,29565,50.2,2018-03-04
2353,116428,91613,77198,14415,18.7,2018-03-05
2352,116747,91932,74384,17548,23.6,2018-03-06
2351,116747,90131,75974,14157,18.6,2018-03-07
2350,116747,90761,78855,11906,15.1,2018-03-08
2349,116747,90418,75922,14496,19.1,2018-03-09
2348,116747,86257,64427,21830,33.9,2018-03-10
2347,116747,85495,59781,25714,43.0,2018-03-11
2346,116747,88956,73285,15671,21.4,2018-03-12
2345,116747,90231,71017,19214,27.1,2018-03-13
2344,116747,90597,68060,22537,33.1,2018-03-14
2343,116747,90695,71174,19521,27.4,2018-03-15
2342,116747,91314,72510,18804,25.9,2018-03-16
2341,116747,87175,61946,25229,40.7,2018-03-17
2340,116747,88083,58324,29759,51.0,2018-03-18
2339,116747,90418,72795,17623,24.2,2018-03-19
2338,116747,90937,72583,18354,25.3,2018-03-20
2337,116747,90501,78017,12484,16.0,2018-03-21
2336,116747,90196,73423,16773,22.8,2018-03-22
2335,116747,89581,72231,17350,24.0,2018-03-23
2334,116747,87003,61698,25305,41.0,2018-03-24
2333,116747,86394,57513,28881,50.2,2018-03-25
2332,116747,89715,69467,20248,29.1,2018-03-26
2331,116747,88147,67622,20525,30.4,2018-03-27
2330,116747,87816,66068,21748,32.9,2018-03-28
2329,116747,87826,67110,20716,30.9,2018-03-29
2328,116747,89166,65637,23529,35.8,2018-03-30
2327,116747,85067,57558,27509,47.8,2018-03-31
2326,116747,84193,56397,27796,49.3,2018-04-01
2325,116747,83579,65846,17733,26.9,2018-04-02
2324,116747,84946,66335,18611,28.1,2018-04-03
2323,116747,85253,68281,16972,24.9,2018-04-04
2322,116747,84634,70520,14114,20.0,2018-04-05
2321,116747,83403,69296,14107,20.4,2018-04-06
2320,116747,81063,60912,20151,33.1,2018-04-07
2319,116747,82219,58110,24109,41.5,2018-04-08
2318,116747,83521,68149,15372,22.6,2018-04-09
2317,116747,82433,66523,15910,23.9,2018-04-10
2316,116747,81614,65533,16081,24.5,2018-04-11
2315,116747,81768,66438,15330,23.1,2018-04-12
2314,116747,81726,66251,15475,23.4,2018-04-13
2313,116747,81200,62481,18719,30.0,2018-04-14
2312,116747,80067,56623,23444,41.4,2018-04-15
2311,116747,79121,65800,13321,20.2,2018-04-16
2310,116747,77568,66456,11112,16.7,2018-04-17
2309,116747,78400,65506,12894,19.7,2018-04-18
2308,116747,78924,66264,12660,19.1,2018-04-19
2307,116747,78947,65575,13372,20.4,2018-04-20
2306,116747,78552,57277,21275,37.1,2018-04-21
2305,116747,77731,56420,21311,37.8,2018-04-22
2304,116747,79894,69692,10202,14.6,2018-04-23
2303,116747,79133,68449,10684,15.6,2018-04-24
2302,116747,76747,64939,11808,18.2,2018-04-25
2301,116747,78154,65403,12751,19.5,2018-04-26
2300,116747,79175,64547,14628,22.7,2018-04-27
2299,116747,78144,56946,21198,37.2,2018-04-28
2298,116747,77172,55893,21279,38.1,2018-04-29
2297,116747,80785,64781,16004,24.7,2018-04-30
2296,116747,81580,60435,21145,35.0,2018-05-01
2295,116747,81261,67840,13421,19.8,2018-05-02
2294,116747,80297,65747,14550,22.1,2018-05-03
2293,117589,81094,63828,17266,27.1,2018-05-04
2292,117589,79174,56278,22896,40.7,2018-05-05
2291,117589,80610,55321,25289,45.7,2018-05-06
2290,117589,80891,60354,20537,34.0,2018-05-07
2289,117589,79415,65600,13815,21.1,2018-05-08
2288,117589,79444,65350,14094,21.6,2018-05-09
2287,117589,79074,65752,13322,20.3,2018-05-10
2286,117589,79009,65425,13584,20.8,2018-05-11
2285,117589,75171,60553,14618,24.1,2018-05-12
2284,117589,76940,55959,20981,37.5,2018-05-13
2283,117589,79618,66805,12813,19.2,2018-05-14
2282,117589,80592,70067,10525,15.0,2018-05-15
2281,117589,82967,72229,10738,14.9,2018-05-16
2280,117589,82000,73173,8827,12.1,2018-05-17
2279,117589,81942,70160,11782,16.8,2018-05-18
2278,117589,79015,57867,21148,36.5,2018-05-19
2277,117589,78999,55326,23673,42.8,2018-05-20
2276,117589,80612,64307,16305,25.4,2018-05-21
2275,117589,81093,60900,20193,33.2,2018-05-22
2274,117589,80982,65409,15573,23.8,2018-05-23
2273,117589,79966,66977,12989,19.4,2018-05-24
2272,117589,80698,67071,13627,20.3,2018-05-25
2271,117589,76661,58811,17850,30.4,2018-05-26
2270,117589,78783,56576,22207,39.3,2018-05-27
2269,117589,80264,70232,10032,14.3,2018-05-28
2268,117589,81615,70664,10951,15.5,2018-05-29
2267,117589,83449,70407,13042,18.5,2018-05-30
2266,117790,84738,69024,15714,22.8,2018-05-31
2265,117790,83704,70127,13577,19.4,2018-06-01
2264,117790,80601,59990,20611,34.4,2018-06-02
2263,117790,79806,58359,21447,36.8,2018-06-03
2262,117790,81586,71429,10157,14.2,2018-06-04
2261,117790,82500,71221,11279,15.8,2018-06-05
2260,117790,82133,65117,17016,26.1,2018-06-06
2259,117790,82558,73379,9179,12.5,2018-06-07
2258,117790,83419,71187,12232,17.2,2018-06-08
2257,117790,82730,61116,21614,35.4,2018-06-09
2256,117790,83297,56753,26544,46.8,2018-06-10
2255,117790,84435,68243,16192,23.7,2018-06-11
2254,117790,84032,68930,15102,21.9,2018-06-12
2253,117790,85139,65009,20130,31.0,2018-06-13
2252,117790,85370,68133,17237,25.3,2018-06-14
2251,117790,85115,68421,16694,24.4,2018-06-15
2250,117790,83170,58833,24337,41.4,2018-06-16
2249,117790,83729,58275,25454,43.7,2018-06-17
2248,117790,84329,73210,11119,15.2,2018-06-18
2247,117790,84861,72215,12646,17.5,2018-06-19
2246,117790,85079,72551,12528,17.3,2018-06-20
2245,117790,86791,72656,14135,19.5,2018-06-21
2244,117111,86209,73832,12377,16.8,2018-06-22
2243,117111,83862,61832,22030,35.6,2018-06-23
2242,117111,84269,60899,23370,38.4,2018-06-24
2241,117111,87256,76606,10650,13.9,2018-06-25
2240,117111,89067,75237,13830,18.4,2018-06-26
2239,117111,87793,74803,12990,17.4,2018-06-27
2238,117111,88067,74820,13247,17.7,2018-06-28
2237,117111,89332,75049,14283,19.0,2018-06-29
2236,117205,88076,65571,22505,34.3,2018-06-30
2235,117205,87679,60609,27070,44.7,2018-07-01
2234,117205,89068,75611,13457,17.8,2018-07-02
2233,117205,89020,77312,11708,15.1,2018-07-03
2232,117205,89359,78919,10440,13.2,2018-07-04
2231,117205,91119,77530,13589,17.5,2018-07-05
2230,117205,91535,73639,17896,24.3,2018-07-06
2229,117205,89827,60855,28972,47.6,2018-07-07
2228,117205,90879,58944,31935,54.2,2018-07-08
2227,117205,95045,70920,24125,34.0,2018-07-09
2226,117205,95595,76258,19337,25.4,2018-07-10
2225,117205,96148,79406,16742,21.1,2018-07-11
2224,117205,96809,81393,15416,18.9,2018-07-12
2223,117205,95558,82076,13482,16.4,2018-07-13
2222,117205,92605,70700,21905,31.0,2018-07-14
2221,117205,93127,69798,23329,33.4,2018-07-15
2220,117205,95758,86306,9452,11.0,2018-07-16
2219,117205,97112,86286,10826,12.5,2018-07-17
2218,117205,97759,86710,11049,12.7,2018-07-18
2217,117205,97937,87591,10346,11.8,2018-07-19
2216,117205,97502,88080,9422,10.7,2018-07-20
2215,117205,95628,76999,18629,24.2,2018-07-21
2214,117205,97241,73794,23447,31.8,2018-07-22
2213,117205,98296,90695,7601,8.4,2018-07-23
2212,117205,99570,92478,7092,7.7,2018-07-24
2211,117205,99296,90399,8897,9.8,2018-07-25
2210,117205,99309,90682,8627,9.5,2018-07-26
2209,117205,99117,90678,8439,9.3,2018-07-27
2208,117477,92232,77487,14745,19.0,2018-07-28
2207,117477,92104,72063,20041,27.8,2018-07-29
2206,117477,96016,82882,13134,15.8,2018-07-30
2205,117477,96087,83087,13000,15.6,2018-07-31
2204,117840,96321,82486,13835,16.8,2018-08-01
2203,117840,97975,82283,15692,19.1,2018-08-02
2202,117840,99023,81589,17434,21.4,2018-08-03
2201,117840,95423,74087,21336,28.8,2018-08-04
2200,117840,95002,74791,20211,27.0,2018-08-05
2199,117840,99237,88816,10421,11.7,2018-08-06
2198,117840,99399,88873,10526,11.8,2018-08-07
2197,117840,99829,88955,10874,12.2,2018-08-08
2196,117840,99902,88582,11320,12.8,2018-08-09
2195,117840,100189,87807,12382,14.1,2018-08-10
2194,117840,90671,75167,15504,20.6,2018-08-11
2193,117840,90835,73509,17326,23.6,2018-08-12
2192,117840,100194,91405,8789,9.6,2018-08-13
2191,117840,100250,91548,8702,9.5,2018-08-14
2190,117840,98106,83275,14831,17.8,2018-08-15
2189,117840,99943,88720,11223,12.6,2018-08-16
2188,117840,99458,80289,19169,23.9,2018-08-17
2187,117840,93030,67131,25899,38.6,2018-08-18
2186,117840,93003,66730,26273,39.4,2018-08-19
2185,117840,99274,83917,15357,18.3,2018-08-20
2184,117840,98147,84025,14122,16.8,2018-08-21
2183,117840,97791,87911,9880,11.2,2018-08-22
2182,117840,98679,84786,13893,16.4,2018-08-23
2181,117840,98764,79844,18920,23.7,2018-08-24
2180,117840,91111,68483,22628,33.0,2018-08-25
2179,117840,89602,61434,28168,45.9,2018-08-26
2178,117840,98259,77224,21035,27.2,2018-08-27
2177,117840,98287,79359,18928,23.9,2018-08-28
2176,117840,97798,80284,17514,21.8,2018-08-29
2175,117996,97129,81281,15848,19.5,2018-08-30
2174,117996,97053,77420,19633,25.4,2018-08-31
2173,117996,92587,65117,27470,42.2,2018-09-01
2172,117996,91846,62574,29272,46.8,2018-09-02
2171,117996,94223,78405,15818,20.2,2018-09-03
2170,117996,94239,76268,17971,23.6,2018-09-04
2169,117996,94830,75416,19414,25.7,2018-09-05
2168,117996,94775,76604,18171,23.7,2018-09-06
2167,117996,94835,73304,21531,29.4,2018-09-07
2166,117996,86196,61542,24654,40.1,2018-09-08
2165,117996,88849,59747,29102,48.7,2018-09-09
2164,117996,91723,72230,19493,27.0,2018-09-10
2163,117996,92845,71320,21525,30.2,2018-09-11
2162,117996,92726,73004,19722,27.0,2018-09-12
2161,117996,92278,73607,18671,25.4,2018-09-13
2160,117996,92337,73530,18807,25.6,2018-09-14
2159,117996,87380,64896,22484,34.6,2018-09-15
2158,117996,84610,61788,22822,36.9,2018-09-16
2157,117996,92041,73080,18961,25.9,2018-09-17
2156,117996,92418,72897,19521,26.8,2018-09-18
2155,117996,92949,72654,20295,27.9,2018-09-19
2154,117996,93862,71784,22078,30.8,2018-09-20
2153,117996,95074,69729,25345,36.3,2018-09-21
2152,117996,89729,57029,32700,57.3,2018-09-22
2151,117996,88136,51604,36532,70.8,2018-09-23
2150,117996,87986,47981,40005,83.4,2018-09-24
2149,117996,87802,51414,36388,70.8,2018-09-25
2148,117996,87542,55992,31550,56.3,2018-09-26
2147,117996,88882,65404,23478,35.9,2018-09-27
2146,117996,87832,66524,21308,32.0,2018-09-28
2145,117996,85117,59632,25485,42.7,2018-09-29
2144,117996,85610,57311,28299,49.4,2018-09-30
2143,117996,84255,66789,17466,26.2,2018-10-01
2142,117996,83866,66291,17575,26.5,2018-10-02
2141,117996,82997,63204,19793,31.3,2018-10-03
2140,117996,83069,68210,14859,21.8,2018-10-04
2139,117996,83732,68545,15187,22.2,2018-10-05
2138,117996,80345,60380,19965,33.1,2018-10-06
2137,117996,80216,56947,23269,40.9,2018-10-07
2136,117996,82849,66445,16404,24.7,2018-10-08
2135,117996,81359,63339,18020,28.5,2018-10-09
2134,117996,80746,67212,13534,20.1,2018-10-10
2133,117996,82365,67931,14434,21.2,2018-10-11
2132,117996,83471,66908,16563,24.8,2018-10-12
2131,117996,79514,58171,21343,36.7,2018-10-13
2130,117996,80738,57197,23541,41.2,2018-10-14
2129,117996,82338,67919,14419,21.2,2018-10-15
2128,117996,80683,68140,12543,18.4,2018-10-16
2127,117996,81346,67428,13918,20.6,2018-10-17
2126,117996,81609,68273,13336,19.5,2018-10-18
2125,117996,81181,66699,14482,21.7,2018-10-19
2124,117996,77857,58460,19397,33.2,2018-10-20
2123,117996,78562,57268,21294,37.2,2018-10-21
2122,117996,80080,67942,12138,17.9,2018-10-22
2121,117996,79919,68261,11658,17.1,2018-10-23
2120,117996,80567,67241,13326,19.8,2018-10-24
2119,117996,80187,68029,12158,17.9,2018-10-25
2118,117996,78637,68352,10285,15.0,2018-10-26
2117,117996,78853,59055,19798,33.5,2018-10-27
2116,117996,80886,57363,23523,41.0,2018-10-28
2115,117996,84867,69629,15238,21.9,2018-10-29
2114,117996,84796,70329,14467,20.6,2018-10-30
2113,117996,84708,69211,15497,22.4,2018-10-31
2112,117996,85019,69302,15717,22.7,2018-11-01
2111,117996,86318,68213,18105,26.5,2018-11-02
2110,117996,84461,59940,24521,40.9,2018-11-03
2109,117996,83304,58032,25272,43.5,2018-11-04
2108,117996,85339,68082,17257,25.3,2018-11-05
2107,117996,86299,68452,17847,26.1,2018-11-06
2106,117996,86002,70063,15939,22.7,2018-11-07
2105,117996,88392,71046,17346,24.4,2018-11-08
2104,117996,88746,69575,19171,27.6,2018-11-09
2103,117996,85852,59583,26269,44.1,2018-11-10
2102,117996,85994,58243,27751,47.6,2018-11-11
2101,117996,88116,67888,20228,29.8,2018-11-12
2100,117996,88097,69176,18921,27.4,2018-11-13
2099,117996,87850,69403,18447,26.6,2018-11-14
2098,117996,88965,69041,19924,28.9,2018-11-15
2097,117996,89388,71160,18228,25.6,2018-11-16
2096,118266,89280,60668,28612,47.2,2018-11-17
2095,118266,88836,59566,29270,49.1,2018-11-18
2094,118266,89749,71325,18424,25.8,2018-11-19
2093,118266,89359,72086,17273,24.0,2018-11-20
2092,118266,88807,74205,14602,19.7,2018-11-21
2091,118266,89678,73930,15748,21.3,2018-11-22
2090,118266,89284,74515,14769,19.8,2018-11-23
2089,118266,89340,66283,23057,34.8,2018-11-24
2088,118266,88825,60418,28407,47.0,2018-11-25
2087,118266,90334,74393,15941,21.4,2018-11-26
2086,118266,91509,74408,17101,23.0,2018-11-27
2085,118266,92262,74495,17767,23.8,2018-11-28
2084,118266,93480,75914,17566,23.1,2018-11-29
2083,118266,94970,74676,20294,27.2,2018-11-30
2082,118266,93351,63484,29867,47.0,2018-12-01
2081,118266,91105,60232,30873,51.3,2018-12-02
2080,118266,93342,73728,19614,26.6,2018-12-03
2079,118266,95299,73600,21699,29.5,2018-12-04
2078,118266,95421,76287,19134,25.1,2018-12-05
2077,118266,94062,78157,15905,20.4,2018-12-06
2076,118266,96189,82072,14117,17.2,2018-12-07
2075,118266,95541,69510,26031,37.4,2018-12-08
2074,118266,95642,67263,28379,42.2,2018-12-09
2073,118266,97775,83776,13999,16.7,2018-12-10
2072,118266,98271,85463,12808,15.0,2018-12-11
2071,118266,97110,83447,13663,16.4,2018-12-12
2070,118266,97903,83702,14201,17.0,2018-12-13
2069,118266,98032,83871,14161,16.9,2018-12-14
2068,118266,97154,70400,26754,38.0,2018-12-15
2067,118266,95867,65711,30156,45.9,2018-12-16
2066,118266,96268,81991,14277,17.4,2018-12-17
2065,118266,95992,81939,14053,17.2,2018-12-18
2064,118266,97325,80550,16775,20.8,2018-12-19
2063,119092,97431,81081,16350,20.2,2018-12-20
2062,119092,96871,79490,17381,21.9,2018-12-21
2061,119092,94130,65656,28474,43.4,2018-12-22
2060,119092,98751,63817,34934,54.7,2018-12-23
2059,119092,100733,77453,23280,30.1,2018-12-24
2058,119092,99769,67836,31933,47.1,2018-12-25
2057,119092,101432,79897,21535,27.0,2018-12-26
2056,119092,101923,84377,17546,20.8,2018-12-27
2055,119092,100841,86083,14758,17.1,2018-12-28
2054,119092,99181,71171,28010,39.4,2018-12-29
2053,119092,98344,67295,31049,46.1,2018-12-30
2052,119092,101763,74652,27111,36.3,2018-12-31
2051,119092,100043,65493,34550,52.8,2019-01-01
2050,119092,101149,82437,18712,22.7,2019-01-02
2049,119092,99695,84196,15499,18.4,2019-01-03
2048,119092,100294,84746,15548,18.3,2019-01-04
2047,119092,99505,69496,30009,43.2,2019-01-05
2046,119092,98748,66493,32255,48.5,2019-01-06
2045,119092,101091,84074,17017,20.2,2019-01-07
2044,119092,100948,83818,17130,20.4,2019-01-08
2043,119092,100827,85392,15435,18.1,2019-01-09
2042,119092,101064,83833,17231,20.6,2019-01-10
2041,119092,99990,81941,18049,22.0,2019-01-11
2040,119092,98303,68147,30156,44.3,2019-01-12
2039,119092,97990,64545,33445,51.8,2019-01-13
2038,119092,98333,81783,16550,20.2,2019-01-14
2037,119092,98347,81378,16969,20.9,2019-01-15
2036,119092,101806,84401,17405,20.6,2019-01-16
2035,119092,101011,82611,18400,22.3,2019-01-17
2034,119092,101500,81668,19832,24.3,2019-01-18
2033,119092,99028,67950,31078,45.7,2019-01-19
2032,119092,99561,65830,33731,51.2,2019-01-20
2031,119092,99530,82668,16862,20.4,2019-01-21
2030,119092,100320,81134,19186,23.6,2019-01-22
2029,119092,100337,80794,19543,24.2,2019-01-23
2028,119350,99535,80239,19296,24.0,2019-01-24
2027,119350,99688,81007,18681,23.1,2019-01-25
2026,119350,97796,68954,28842,41.8,2019-01-26
2025,119350,97470,65189,32281,49.5,2019-01-27
2024,119350,99745,80399,19346,24.1,2019-01-28
2023,119350,100298,81215,19083,23.5,2019-01-29
2022,119350,99728,80741,18987,23.5,2019-01-30
2021,119350,99590,83652,15938,19.1,2019-01-31
2020,119350,99950,80556,19394,24.1,2019-02-01
2019,119350,96386,67202,29184,43.4,2019-02-02
2018,119350,96030,60334,35696,59.2,2019-02-03
2017,119350,94102,57603,36499,63.4,2019-02-04
2016,119350,94577,55340,39237,70.9,2019-02-05
2015,119350,95737,56835,38902,68.4,2019-02-06
2014,119350,97979,72824,25155,34.5,2019-02-07
2013,119350,99739,79253,20486,25.8,2019-02-08
2012,119350,98259,67498,30761,45.6,2019-02-09
2011,119350,97303,65225,32078,49.2,2019-02-10
2010,119350,98662,81369,17293,21.3,2019-02-11
2009,119350,98910,81684,17226,21.1,2019-02-12
2008,119350,98297,80849,17448,21.6,2019-02-13
2007,119350,98101,81477,16624,20.4,2019-02-14
2006,119350,98165,81471,16694,20.5,2019-02-15
2005,119350,95215,67769,27446,40.5,2019-02-16
2004,119350,96719,64033,32686,51.0,2019-02-17
2003,119350,97919,80394,17525,21.8,2019-02-18
2002,119350,98738,82869,15869,19.1,2019-02-19
2001,119350,97769,79777,17992,22.6,2019-02-20
2000,119350,97508,78291,19217,24.5,2019-02-21
1999,119350,95280,77656,17624,22.7,2019-02-22
1998,119350,94747,65016,29731,45.7,2019-02-23
1997,119350,92101,60881,31220,51.3,2019-02-24
1996,119350,93529,74848,18681,25.0,2019-02-25
1995,119350,96495,74488,22007,29.5,2019-02-26
1994,119350,96168,74792,21376,28.6,2019-02-27
1993,119350,96915,73115,23800,32.6,2019-02-28
1992,119350,91637,63532,28105,44.2,2019-03-01
1991,119350,93202,60563,32639,53.9,2019-03-02
1990,119350,93415,59211,34204,57.8,2019-03-03
1989,119350,91523,71880,19643,27.3,2019-03-04
1988,119350,89577,73603,15974,21.7,2019-03-05
1987,119350,90340,73573,16767,22.8,2019-03-06
1986,119350,90568,72780,17788,24.4,2019-03-07
1985,119350,91780,72390,19390,26.8,2019-03-08
1984,119350,90590,62527,28063,44.9,2019-03-09
1983,119350,90342,59584,30758,51.6,2019-03-10
1982,119350,90487,72149,18338,25.4,2019-03-11
1981,119350,90181,73773,16408,22.2,2019-03-12
1980,119350,90422,74136,16286,22.0,2019-03-13
1979,119350,91332,73378,17954,24.5,2019-03-14
1978,119350,91330,73568,17762,24.1,2019-03-15
1977,119350,91308,63088,28220,44.7,2019-03-16
1976,119350,91088,59480,31608,53.1,2019-03-17
1975,119350,89700,72008,17692,24.6,2019-03-18
1974,119350,89997,70866,19131,27.0,2019-03-19
1973,119350,88590,71675,16915,23.6,2019-03-20
1972,119350,89654,71884,17770,24.7,2019-03-21
1971,119350,90789,71617,19172,26.8,2019-03-22
1970,119350,89921,62029,27892,45.0,2019-03-23
1969,119350,90705,59274,31431,53.0,2019-03-24
1968,119350,88593,72375,16218,22.4,2019-03-25
1967,119350,88814,70390,18424,26.2,2019-03-26
1966,119826,88343,68679,19664,28.6,2019-03-27
1965,119826,87696,68576,19120,27.9,2019-03-28
1964,119826,89996,67957,22039,32.4,2019-03-29
1963,119826,90805,59993,30812,51.4,2019-03-30
1962,119826,91010,59005,32005,54.2,2019-03-31
1961,119826,89580,68918,20662,30.0,2019-04-01
1960,119826,89630,69375,20255,29.2,2019-04-02
1959,119826,89340,68911,20429,29.6,2019-04-03
1958,119826,88395,68612,19783,28.8,2019-04-04
1957,119826,88423,69788,18635,26.7,2019-04-05
1956,119826,85244,59799,25445,42.6,2019-04-06
1955,119826,85169,57246,27923,48.8,2019-04-07
1954,119826,86824,66789,20035,30.0,2019-04-08
1953,119826,87976,70499,17477,24.8,2019-04-09
1952,119826,86455,73010,13445,18.4,2019-04-10
1951,119826,85487,68823,16664,24.2,2019-04-11
1950,119826,86705,65841,20864,31.7,2019-04-12
1949,119826,83129,58741,24388,41.5,2019-04-13
1948,119826,82158,57347,24811,43.3,2019-04-14
1947,119826,85512,65652,19860,30.3,2019-04-15
1946,119826,83106,65846,17260,26.2,2019-04-16
1945,119826,82570,64858,17712,27.3,2019-04-17
1944,119826,82853,65665,17188,26.2,2019-04-18
1943,119826,84424,67286,17138,25.5,2019-04-19
1942,119826,85289,57536,27753,48.2,2019-04-20
1941,119826,83152,56357,26795,47.5,2019-04-21
1940,119826,81942,65036,16906,26.0,2019-04-22
1939,119826,81557,67676,13881,20.5,2019-04-23
1938,119826,82852,66843,16009,24.0,2019-04-24
1937,119826,83514,68406,15108,22.1,2019-04-25
1936,119826,84099,68703,15396,22.4,2019-04-26
1935,119826,82324,58248,24076,41.3,2019-04-27
1934,119826,80878,56304,24574,43.6,2019-04-28
1933,119826,82947,68904,14043,20.4,2019-04-29
1932,119826,82853,65866,16987,25.8,2019-04-30
1931,119826,81645,59257,22388,37.8,2019-05-01
1930,119826,82415,64347,18068,28.1,2019-05-02
1929,119826,81989,63488,18501,29.1,2019-05-03
1928,119826,80918,55891,25027,44.8,2019-05-04
1927,119826,79335,54877,24458,44.6,2019-05-05
1926,119826,81530,59232,22298,37.6,2019-05-06
1925,119826,79503,64119,15384,24.0,2019-05-07
1924,119826,78364,65191,13173,20.2,2019-05-08
1923,119826,80556,64637,15919,24.6,2019-05-09
1922,119826,81679,65051,16628,25.6,2019-05-10
1921,119826,79703,56737,22966,40.5,2019-05-11
1920,119826,79573,55971,23602,42.2,2019-05-12
1919,119826,80443,66385,14058,21.2,2019-05-13
1918,119826,80697,66716,13981,21.0,2019-05-14
1917,119826,80361,68076,12285,18.0,2019-05-15
1916,119826,83421,69631,13790,19.8,2019-05-16
1915,119826,85369,69583,15786,22.7,2019-05-17
1914,119826,86935,58102,28833,49.6,2019-05-18
1913,119826,85663,57545,28118,48.9,2019-05-19
1912,119826,85532,64838,20694,31.9,2019-05-20
1911,119826,84904,65571,19333,29.5,2019-05-21
1910,119826,85640,66689,18951,28.4,2019-05-22
1909,119826,85870,68535,17335,25.3,2019-05-23
1908,119826,86270,70964,15306,21.6,2019-05-24
1907,119826,82940,58952,23988,40.7,2019-05-25
1906,119826,81999,57613,24386,42.3,2019-05-26
1905,119826,86044,69700,16344,23.4,2019-05-27
1904,119826,85268,66168,19100,28.9,2019-05-28
1903,119826,85854,67474,18380,27.2,2019-05-29
1902,119826,85645,68850,16795,24.4,2019-05-30
1901,119826,87936,64992,22944,35.3,2019-05-31
1900,119826,88112,56860,31252,55.0,2019-06-01
1899,119826,87594,56758,30836,54.3,2019-06-02
1898,119826,88900,69235,19665,28.4,2019-06-03
1897,119826,90564,70611,19953,28.3,2019-06-04
1896,119826,90898,70897,20001,28.2,2019-06-05
1895,119826,90589,65996,24593,37.3,2019-06-06
1894,119826,92817,65956,26861,40.7,2019-06-07
1893,119826,88149,57222,30927,54.0,2019-06-08
1892,119826,87928,56627,31301,55.3,2019-06-09
1891,119826,87694,67097,20597,30.7,2019-06-10
1890,119826,88715,67125,21590,32.2,2019-06-11
1889,120471,88232,68360,19872,29.1,2019-06-12
1888,120471,88551,69302,19249,27.8,2019-06-13
1887,120471,88949,70094,18855,26.9,2019-06-14
1886,120471,87091,58299,28792,49.4,2019-06-15
1885,120471,86679,57589,29090,50.5,2019-06-16
1884,120471,89409,69144,20265,29.3,2019-06-17
1883,120471,90120,70283,19837,28.2,2019-06-18
1882,120471,89717,71045,18672,26.3,2019-06-19
1881,120471,90492,72419,18073,25.0,2019-06-20
1880,120471,90556,71392,19164,26.8,2019-06-21
1879,120471,88896,59611,29285,49.1,2019-06-22
1878,120471,88127,58504,29623,50.6,2019-06-23
1877,120471,90467,72358,18109,25.0,2019-06-24
1876,120471,89869,74192,15677,21.1,2019-06-25
1875,120471,89983,72691,17292,23.8,2019-06-26
1874,120471,90520,75206,15314,20.4,2019-06-27
1873,120471,90337,73877,16460,22.3,2019-06-28
1872,121147,87932,61863,26069,42.1,2019-06-29
1871,121147,87921,60661,27260,44.9,2019-06-30
1870,121147,91817,73799,18018,24.4,2019-07-01
1869,121147,92227,73871,18356,24.8,2019-07-02
1868,121147,92712,74051,18661,25.2,2019-07-03
1867,121147,93946,75978,17968,23.6,2019-07-04
1866,121147,94391,77081,17310,22.5,2019-07-05
1865,121147,91649,64664,26985,41.7,2019-07-06
1864,121147,92607,61231,31376,51.2,2019-07-07
1863,121147,94434,74511,19923,26.7,2019-07-08
1862,121147,94279,74847,19432,26.0,2019-07-09
1861,121147,95999,73582,22417,30.5,2019-07-10
1860,121147,95381,73762,21619,29.3,2019-07-11
1859,121147,94222,73720,20502,27.8,2019-07-12
1858,121147,93081,62192,30889,49.7,2019-07-13
1857,121147,93017,62384,30633,49.1,2019-07-14
1856,121147,94590,75227,19363,25.7,2019-07-15
1855,121147,94626,77005,17621,22.9,2019-07-16
1854,121147,95420,77875,17545,22.5,2019-07-17
1853,121147,95445,78538,16907,21.5,2019-07-18
1852,121147,95691,81037,14654,18.1,2019-07-19
1851,121147,94148,68096,26052,38.3,2019-07-20
1850,121147,94528,64826,29702,45.8,2019-07-21
1849,121147,97038,81923,15115,18.5,2019-07-22
1848,121147,95593,84164,11429,13.6,2019-07-23
1847,121147,97332,82716,14616,17.7,2019-07-24
1846,121147,96927,82349,14578,17.7,2019-07-25
1845,121147,97280,80943,16337,20.2,2019-07-26
1844,121147,96160,71548,24612,34.4,2019-07-27
1843,121147,95524,67137,28387,42.3,2019-07-28
1842,121147,97017,80114,16903,21.1,2019-07-29
1841,121147,97149,81567,15582,19.1,2019-07-30
1840,121147,97185,78182,19003,24.3,2019-07-31
1839,121147,97699,77967,19732,25.3,2019-08-01
1838,121147,97519,77913,19606,25.2,2019-08-02
1837,121147,94116,70485,23631,33.5,2019-08-03
1836,121147,95160,70852,24308,34.3,2019-08-04
1835,121147,97013,82885,14128,17.0,2019-08-05
1834,121147,97597,82491,15106,18.3,2019-08-06
1833,121147,98026,81077,16949,20.9,2019-08-07
1832,121147,97218,84356,12862,15.2,2019-08-08
1831,121147,97267,85400,11867,13.9,2019-08-09
1830,121147,93371,75211,18160,24.1,2019-08-10
1829,121147,94097,73304,20793,28.4,2019-08-11
1828,121147,97108,86941,10167,11.7,2019-08-12
1827,121147,96389,90314,6075,6.7,2019-08-13
1826,121147,98540,90052,8488,9.4,2019-08-14
1825,121147,96663,75693,20970,27.7,2019-08-15
1824,121147,98046,81147,16899,20.8,2019-08-16
1823,121147,96653,68337,28316,41.4,2019-08-17
1822,121147,96791,66051,30740,46.5,2019-08-18
1821,121147,98558,81590,16968,20.8,2019-08-19
1820,121147,98607,83162,15445,18.6,2019-08-20
1819,121147,99640,83782,15858,18.9,2019-08-21
1818,121147,100471,82264,18207,22.1,2019-08-22
1817,121147,100326,79012,21314,27.0,2019-08-23
1816,121147,98115,64735,33380,51.6,2019-08-24
1815,121147,98253,63326,34927,55.2,2019-08-25
1814,121147,99869,79478,20391,25.7,2019-08-26
1813,121147,99787,77998,21789,27.9,2019-08-27
1812,121147,99232,79037,20195,25.6,2019-08-28
1811,121147,99833,76683,23150,30.2,2019-08-29
1810,122973,99882,73735,26147,35.5,2019-08-30
1809,122973,97968,63393,34575,54.5,2019-08-31
1808,122973,97308,61847,35461,57.3,2019-09-01
1807,122973,96412,76231,20181,26.5,2019-09-02
1806,122973,95152,77067,18085,23.5,2019-09-03
1805,122973,95358,77939,17419,22.3,2019-09-04
1804,122973,96786,79390,17396,21.9,2019-09-05
1803,122973,96032,79916,16116,20.2,2019-09-06
1802,122973,94243,68972,25271,36.6,2019-09-07
1801,122973,92823,65686,27137,41.3,2019-09-08
1800,122973,92717,78980,13737,17.4,2019-09-09
1799,122490,91977,78650,13327,16.9,2019-09-10
1798,122490,92360,73271,19089,26.1,2019-09-11
1797,122490,89300,55025,34275,62.3,2019-09-12
1796,122490,87867,50583,37284,73.7,2019-09-13
1795,122490,87824,55077,32747,59.5,2019-09-14
1794,122490,87737,58401,29336,50.2,2019-09-15
1793,122490,88841,71926,16915,23.5,2019-09-16
1792,122490,88944,72654,16290,22.4,2019-09-17
1791,122490,90221,71310,18911,26.5,2019-09-18
1790,122490,90289,71203,19086,26.8,2019-09-19
1789,122490,89961,68997,20964,30.4,2019-09-20
1788,122490,83252,60423,22829,37.8,2019-09-21
1787,122490,85676,57175,28501,49.8,2019-09-22
1786,122490,87757,67955,19802,29.1,2019-09-23
1785,122490,87436,68030,19406,28.5,2019-09-24
1784,122490,84067,69484,14583,21.0,2019-09-25
1783,122490,84644,70942,13702,19.3,2019-09-26
1782,122490,84363,70695,13668,19.3,2019-09-27
1781,122490,83347,61652,21695,35.2,2019-09-28
1780,122490,84097,59910,24187,40.4,2019-09-29
1779,122490,84371,72703,11668,16.0,2019-09-30
1778,122490,83471,73550,9921,13.5,2019-10-01
1777,122490,85176,72674,12502,17.2,2019-10-02
1776,122490,81703,65389,16314,24.9,2019-10-03
1775,122490,80662,69517,11145,16.0,2019-10-04
1774,122490,81526,58463,23063,39.4,2019-10-05
1773,122490,83945,56929,27016,47.5,2019-10-06
1772,122490,82629,67701,14928,22.0,2019-10-07
1771,122490,82189,66068,16121,24.4,2019-10-08
1770,122490,81179,62364,18815,30.2,2019-10-09
1769,122490,80267,66814,13453,20.1,2019-10-10
1768,122490,80279,65826,14453,22.0,2019-10-11
1767,122490,79668,56963,22705,39.9,2019-10-12
1766,122490,84062,56189,27873,49.6,2019-10-13
1765,122490,80774,66445,14329,21.6,2019-10-14
1764,122490,81374,66840,14534,21.7,2019-10-15
1763,122490,82263,65339,16924,25.9,2019-10-16
1762,122490,81826,65896,15930,24.2,2019-10-17
1761,122490,82388,66319,16069,24.2,2019-10-18
1760,122490,79662,57570,22092,38.4,2019-10-19
1759,122490,82594,56578,26016,46.0,2019-10-20
1758,122490,80786,66898,13888,20.8,2019-10-21
1757,122490,81746,67468,14278,21.2,2019-10-22
1756,122490,81763,67006,14757,22.0,2019-10-23
1755,122490,82482,66741,15741,23.6,2019-10-24
1754,122490,82728,65970,16758,25.4,2019-10-25
1753,122490,83846,57066,26780,46.9,2019-10-26
1752,122490,84834,56033,28801,51.4,2019-10-27
1751,122490,82434,66673,15761,23.6,2019-10-28
1750,124023,82395,67119,15276,22.8,2019-10-29
1749,124023,81982,66526,15456,23.2,2019-10-30
1748,124023,82886,66888,15998,23.9,2019-10-31
1747,124023,85949,65117,20832,32.0,2019-11-01
1746,124023,85945,56973,28972,50.9,2019-11-02
1745,124023,86064,56036,30028,53.6,2019-11-03
1744,124023,85676,65979,19697,29.9,2019-11-04
1743,124023,85099,66471,18628,28.0,2019-11-05
1742,124023,85861,65837,20024,30.4,2019-11-06
1741,124023,88250,66635,21615,32.4,2019-11-07
1740,124023,88048,66895,21153,31.6,2019-11-08
1739,124023,84573,58848,25725,43.7,2019-11-09
1738,124023,83166,57626,25540,44.3,2019-11-10
1737,124023,85649,67084,18565,27.7,2019-11-11
1736,124023,86750,68342,18408,26.9,2019-11-12
1735,124392,85826,71244,14582,20.5,2019-11-13
1734,124392,87748,72026,15722,21.8,2019-11-14
1733,124392,86729,70876,15853,22.4,2019-11-15
1732,124392,85664,60421,25243,41.8,2019-11-16
1731,124392,85545,58646,26899,45.9,2019-11-17
1730,124392,88940,71848,17092,23.8,2019-11-18
1729,124392,87377,74393,12984,17.5,2019-11-19
1728,124392,86728,74148,12580,17.0,2019-11-20
1727,124392,88463,74041,14422,19.5,2019-11-21
1726,124392,88001,71571,16430,23.0,2019-11-22
1725,124392,83834,60030,23804,39.7,2019-11-23
1724,124392,83730,57696,26034,45.1,2019-11-24
1723,124392,89691,74250,15441,20.8,2019-11-25
1722,124392,89075,72776,16299,22.4,2019-11-26
1721,124392,87376,73684,13692,18.6,2019-11-27
1720,124392,87908,73693,14215,19.3,2019-11-28
1719,124392,89896,73720,16176,21.9,2019-11-29
1718,124392,88910,62203,26707,42.9,2019-11-30
1717,124392,85920,60978,24942,40.9,2019-12-01
1716,124392,89693,76453,13240,17.3,2019-12-02
1715,124392,88648,77950,10698,13.7,2019-12-03
1714,124833,88239,76624,11615,15.2,2019-12-04
1713,124833,90748,80251,10497,13.1,2019-12-05
1712,124833,92934,81787,11147,13.6,2019-12-06
1711,124833,88596,67875,20721,30.5,2019-12-07
1710,124833,88512,64092,24420,38.1,2019-12-08
1709,124833,91032,80600,10432,12.9,2019-12-09
1708,124833,90073,79201,10872,13.7,2019-12-10
1707,124833,89968,76860,13108,17.1,2019-12-11
1706,124833,92176,78241,13935,17.8,2019-12-12
1705,124833,93576,79110,14466,18.3,2019-12-13
1704,124833,89108,64861,24247,37.4,2019-12-14
1703,124833,89090,61405,27685,45.1,2019-12-15
1702,124833,90759,76425,14334,18.8,2019-12-16
1701,124833,90041,77487,12554,16.2,2019-12-17
1700,124854,91281,77666,13615,17.5,2019-12-18
1699,124854,91402,77689,13713,17.7,2019-12-19
1698,124854,90896,79158,11738,14.8,2019-12-20
1697,124854,88121,66564,21557,32.4,2019-12-21
1696,124854,89528,62827,26701,42.5,2019-12-22
1695,124854,91375,78779,12596,16.0,2019-12-23
1694,124854,92536,79456,13080,16.5,2019-12-24
1693,124854,92654,65610,27044,41.2,2019-12-25
1692,124854,92905,79431,13474,17.0,2019-12-26
1691,124854,93985,78548,15437,19.7,2019-12-27
1690,124854,93308,65014,28294,43.5,2019-12-28
1689,124854,94005,62540,31465,50.3,2019-12-29
1688,124854,93749,75158,18591,24.7,2019-12-30
1687,125338,97035,76223,20812,27.3,2019-12-31
1686,125333,96804,64007,32797,51.2,2020-01-01
1685,125333,95372,77180,18192,23.6,2020-01-02
1684,125333,96134,78269,17865,22.8,2020-01-03
1683,125333,94481,65628,28853,44.0,2020-01-04
1682,125333,93438,63231,30207,47.8,2020-01-05
1681,125333,93842,81890,11952,14.6,2020-01-06
1680,125333,94123,80147,13976,17.4,2020-01-07
1679,125333,95463,79002,16461,20.8,2020-01-08
1678,125333,96303,79160,17143,21.7,2020-01-09
1677,125333,95000,79247,15753,19.9,2020-01-10
1676,125333,93323,66148,27175,41.1,2020-01-11
1675,125333,93783,64008,29775,46.5,2020-01-12
1674,125333,94946,80242,14704,18.3,2020-01-13
1673,125353,94425,82329,12096,14.7,2020-01-14
1672,125353,95018,81195,13823,17.0,2020-01-15
1671,125358,94735,82352,12383,15.0,2020-01-16
1670,125358,94484,81303,13181,16.2,2020-01-17
1669,125358,91928,67399,24529,36.4,2020-01-18
1668,125358,92976,64497,28479,44.2,2020-01-19
1667,125358,94545,78922,15623,19.8,2020-01-20
1666,125358,95606,79627,15979,20.1,2020-01-21
1665,125358,94816,81438,13378,16.4,2020-01-22
1664,125358,95986,76229,19757,25.9,2020-01-23
1663,125358,94657,60789,33868,55.7,2020-01-24
1662,125358,92307,54692,37615,68.8,2020-01-25
1661,125358,91368,55281,36087,65.3,2020-01-26
1660,125358,91781,59961,31820,53.1,2020-01-27
1659,125358,93600,72476,21124,29.1,2020-01-28
1658,125358,94774,76016,18758,24.7,2020-01-29
1657,125358,95263,74457,20806,27.9,2020-01-30
1656,125358,95312,75262,20050,26.6,2020-01-31
1655,125358,94104,63369,30735,48.5,2020-02-01
1654,125358,95485,61882,33603,54.3,2020-02-02
1653,125358,95400,76775,18625,24.3,2020-02-03
1652,125358,96258,77877,18381,23.6,2020-02-04
1651,125358,97018,80770,16248,20.1,2020-02-05
1650,125358,97069,81493,15576,19.1,2020-02-06
1649,125358,96718,79761,16957,21.3,2020-02-07
1648,125358,95448,65470,29978,45.8,2020-02-08
1647,125358,96834,62873,33961,54.0,2020-02-09
1646,125358,95475,76445,19030,24.9,2020-02-10
1645,125358,94879,75830,19049,25.1,2020-02-11
1644,125358,93859,77688,16171,20.8,2020-02-12
1643,125887,95029,74042,20987,28.3,2020-02-13
1642,125887,95318,72476,22842,31.5,2020-02-14
1641,125887,93364,60935,32429,53.2,2020-02-15
1640,125887,96078,63497,32581,51.3,2020-02-16
1639,125887,97039,80648,16391,20.3,2020-02-17
1638,125887,96863,80338,16525,20.6,2020-02-18
1637,125887,96894,77972,18922,24.3,2020-02-19
1636,125887,95750,74510,21240,28.5,2020-02-20
1635,125887,96738,73398,23340,31.8,2020-02-21
1634,125887,96245,62123,34122,54.9,2020-02-22
1633,125887,96379,60988,35391,58.0,2020-02-23
1632,125887,96071,71041,25030,35.2,2020-02-24
1631,125887,94728,76417,18311,24.0,2020-02-25
1630,125887,94390,72005,22385,31.1,2020-02-26
1629,125887,93785,70327,23458,33.4,2020-02-27
1628,125887,93914,74398,19516,26.2,2020-02-28
1627,125887,92676,61341,31335,51.1,2020-02-29
1626,125887,90853,59052,31801,53.9,2020-03-01
1625,125887,93738,70171,23567,33.6,2020-03-02
1624,125887,92536,69937,22599,32.3,2020-03-03
1623,125887,92449,71207,21242,29.8,2020-03-04
1622,125887,91190,71279,19911,27.9,2020-03-05
1621,125887,91029,70461,20568,29.2,2020-03-06
1620,125887,87952,61624,26328,42.7,2020-03-07
1619,125887,87904,57799,30105,52.1,2020-03-08
1618,125887,90748,69348,21400,30.9,2020-03-09
1617,125887,90877,73329,17548,23.9,2020-03-10
1616,125887,91229,69189,22040,31.9,2020-03-11
1615,125887,90698,69187,21511,31.1,2020-03-12
1614,125887,89983,69141,20842,30.1,2020-03-13
1613,125887,85307,61420,23887,38.9,2020-03-14
1612,125887,86578,59745,26833,44.9,2020-03-15
1611,125887,89903,69166,20737,30.0,2020-03-16
1610,125887,89602,70633,18969,26.9,2020-03-17
1609,125887,88257,67700,20557,30.4,2020-03-18
1608,125887,88786,68829,19957,29.0,2020-03-19
1607,125887,89277,65269,24008,36.8,2020-03-20
1606,125887,85555,58825,26730,45.4,2020-03-21
1605,125887,84330,56264,28066,49.9,2020-03-22
1604,125887,84764,65294,19470,29.8,2020-03-23
1603,125887,84829,65456,19373,29.6,2020-03-24
1602,125887,84385,64440,19945,31.0,2020-03-25
1601,125887,83727,66984,16743,25.0,2020-03-26
1600,125887,85189,67487,17702,26.2,2020-03-27
1599,125887,83711,57706,26005,45.1,2020-03-28
1598,125887,83156,56117,27039,48.2,2020-03-29
1597,125887,86752,64310,22442,34.9,2020-03-30
1596,125887,86469,64045,22424,35.0,2020-03-31
1595,125887,92044,65397,26647,40.7,2020-04-01
1594,125887,92581,64793,27788,42.9,2020-04-02
1593,125887,92166,63334,28832,45.5,2020-04-03
1592,125887,91190,57117,34073,59.7,2020-04-04
1591,125887,90878,56568,34310,60.7,2020-04-05
1590,125887,91182,64714,26468,40.9,2020-04-06
1589,125887,90860,64082,26778,41.8,2020-04-07
1588,125887,91327,64227,27100,42.2,2020-04-08
1587,126262,89866,64862,25004,38.5,2020-04-09
1586,126262,89377,63376,26001,41.0,2020-04-10
1585,126262,88341,56756,31585,55.7,2020-04-11
1584,126262,87889,56211,31678,56.4,2020-04-12
1583,126262,87519,64411,23108,35.9,2020-04-13
1582,126262,85438,62808,22630,36.0,2020-04-14
1581,126262,85381,59614,25767,43.2,2020-04-15
1580,126262,83416,63018,20398,32.4,2020-04-16
1579,126262,83368,66699,16669,25.0,2020-04-17
1578,126262,81674,55711,25963,46.6,2020-04-18
1577,126262,83068,56027,27041,48.3,2020-04-19
1576,126262,84130,64906,19224,29.6,2020-04-20
1575,126262,85926,64403,21523,33.4,2020-04-21
1574,126262,86202,63868,22334,35.0,2020-04-22
1573,126262,85634,64118,21516,33.6,2020-04-23
1572,126262,88897,62099,26798,43.2,2020-04-24
1571,126262,88784,56341,32443,57.6,2020-04-25
1570,126262,89516,54785,34731,63.4,2020-04-26
1569,126262,90357,62669,27688,44.2,2020-04-27
1568,126262,90838,61242,29596,48.3,2020-04-28
1567,126262,91654,59574,32080,53.8,2020-04-29
1566,126262,93909,55855,38054,68.1,2020-04-30
1565,126262,92948,53435,39513,73.9,2020-05-01
1564,126262,92659,52776,39883,75.6,2020-05-02
1563,126262,91563,53877,37686,69.9,2020-05-03
1562,126262,91579,57080,34499,60.4,2020-05-04
1561,126262,91397,56310,35087,62.3,2020-05-05
1560,126262,89731,61479,28252,46.0,2020-05-06
1559,126580,88789,62127,26662,42.9,2020-05-07
1558,126580,90233,62506,27727,44.4,2020-05-08
1557,126580,87591,55520,32071,57.8,2020-05-09
1556,126580,88343,54608,33735,61.8,2020-05-10
1555,126580,86688,61467,25221,41.0,2020-05-11
1554,126580,88047,61820,26227,42.4,2020-05-12
1553,126580,89183,61203,27980,45.7,2020-05-13
1552,126580,88998,62498,26500,42.4,2020-05-14
1551,126580,88356,64508,23848,37.0,2020-05-15
1550,126580,87257,54733,32524,59.4,2020-05-16
1549,126580,90211,55310,34901,63.1,2020-05-17
1548,126580,88211,65700,22511,34.3,2020-05-18
1547,126580,92441,63817,28624,44.9,2020-05-19
1546,126580,91454,61065,30389,49.8,2020-05-20
1545,126580,90663,61329,29334,47.8,2020-05-21
1544,126580,91340,61067,30273,49.6,2020-05-22
1543,126580,94866,54830,40036,73.0,2020-05-23
1542,126580,96012,54457,41555,76.3,2020-05-24
1541,126580,94923,62174,32749,52.7,2020-05-25
1540,126580,94878,62836,32042,51.0,2020-05-26
1539,126580,93280,61192,32088,52.4,2020-05-27
1538,126580,94699,61697,33002,53.5,2020-05-28
1537,126580,93465,61765,31700,51.3,2020-05-29
1536,126580,93168,54866,38302,69.8,2020-05-30
1535,126798,91572,53975,37597,69.7,2020-05-31
1534,126798,93552,62505,31047,49.7,2020-06-01
1533,126798,92482,64274,28208,43.9,2020-06-02
1532,126798,93068,66004,27064,41.0,2020-06-03
1531,126798,90830,67908,22922,33.8,2020-06-04
1530,126798,91841,67093,24748,36.9,2020-06-05
1529,126798,90868,57796,33072,57.2,2020-06-06
1528,126798,93095,56738,36357,64.1,2020-06-07
1527,126798,93424,70986,22438,31.6,2020-06-08
1526,126798,91007,73065,17942,24.6,2020-06-09
1525,126798,91874,75247,16627,22.1,2020-06-10
1524,126798,91127,72458,18669,25.8,2020-06-11
1523,126798,90658,71925,18733,26.0,2020-06-12
1522,126798,89021,61765,27256,44.1,2020-06-13
1521,126798,89401,58071,31330,54.0,2020-06-14
1520,126798,90337,68945,21392,31.0,2020-06-15
1519,126798,88932,70355,18577,26.4,2020-06-16
1518,126798,86671,71113,15558,21.9,2020-06-17
1517,126798,88958,68208,20750,30.4,2020-06-18
1516,127153,91543,67881,23662,34.9,2020-06-19
1515,127153,90621,58749,31872,54.3,2020-06-20
1514,127153,91226,58769,32457,55.2,2020-06-21
1513,127153,92668,74046,18622,25.1,2020-06-22
1512,127153,93139,74580,18559,24.9,2020-06-23
1511,127153,94036,71085,22951,32.3,2020-06-24
1510,127153,92616,70436,22180,31.5,2020-06-25
1509,127153,94508,67237,27271,40.6,2020-06-26
1508,127153,94225,59168,35057,59.2,2020-06-27
1507,127153,94649,58627,36022,61.4,2020-06-28
1506,127153,93710,71580,22130,30.9,2020-06-29
1505,127338,96204,67390,28814,42.8,2020-06-30
1504,127338,93570,67510,26060,38.6,2020-07-01
1503,127338,95513,70435,25078,35.6,2020-07-02
1502,127338,93248,69956,23292,33.3,2020-07-03
1501,127338,90430,58241,32189,55.3,2020-07-04
1500,127338,94623,58879,35744,60.7,2020-07-05
1499,127338,96795,73331,23464,32.0,2020-07-06
1498,127338,99029,72265,26764,37.0,2020-07-07
1497,127338,98039,74371,23668,31.8,2020-07-08
1496,127338,97338,75675,21663,28.6,2020-07-09
1495,127338,97930,72503,25427,35.1,2020-07-10
1494,127338,96925,61501,35424,57.6,2020-07-11
1493,127338,98333,58411,39922,68.3,2020-07-12
1492,127338,99746,68771,30975,45.0,2020-07-13
1491,127338,99756,68457,31299,45.7,2020-07-14
1490,127338,99753,68952,30801,44.7,2020-07-15
1489,127338,100269,70509,29760,42.2,2020-07-16
1488,127338,99492,71418,28074,39.3,2020-07-17
1487,127338,97009,61204,35805,58.5,2020-07-18
1486,127338,95880,62377,33503,53.7,2020-07-19
1485,127338,98419,73800,24619,33.4,2020-07-20
1484,127819,97779,74450,23329,31.3,2020-07-21
1483,127819,95809,74111,21698,29.3,2020-07-22
1482,127819,97026,72543,24483,33.7,2020-07-23
1481,127819,95911,69401,26510,38.2,2020-07-24
1480,127819,96250,59890,36360,60.7,2020-07-25
1479,127819,96604,60578,36026,59.5,2020-07-26
1478,127819,95989,73006,22983,31.5,2020-07-27
1477,127819,96278,73747,22531,30.6,2020-07-28
1476,127819,97376,73525,23851,32.4,2020-07-29
1475,127819,97773,72981,24792,34.0,2020-07-30
1474,127819,97643,72400,25243,34.9,2020-07-31
1473,127819,97532,62900,34632,55.1,2020-08-01
1472,127819,97712,62345,35367,56.7,2020-08-02
1471,127819,97969,68035,29934,44.0,2020-08-03
1470,127819,98627,71617,27010,37.7,2020-08-04
1469,127819,98490,72543,25947,35.8,2020-08-05
1468,127819,98650,73160,25490,34.8,2020-08-06
1467,127819,98278,72986,25292,34.7,2020-08-07
1466,127819,96841,64649,32192,49.8,2020-08-08
1465,127819,98702,65302,33400,51.1,2020-08-09
1464,127819,97823,80229,17594,21.9,2020-08-10
1463,127819,97735,79148,18587,23.5,2020-08-11
1462,127819,97600,82122,15478,18.8,2020-08-12
1461,127819,99086,83777,15309,18.3,2020-08-13
1460,127819,99312,82639,16673,20.2,2020-08-14
1459,127819,97614,72195,25419,35.2,2020-08-15
1458,127819,97669,70452,27217,38.6,2020-08-16
1457,127819,97376,78553,18823,24.0,2020-08-17
1456,127819,98698,86324,12374,14.3,2020-08-18
1455,127819,99866,86698,13168,15.2,2020-08-19
1454,127819,98613,86967,11646,13.4,2020-08-20
1453,127819,99830,84425,15405,18.2,2020-08-21
1452,127819,97583,69559,28024,40.3,2020-08-22
1451,127819,97178,68538,28640,41.8,2020-08-23
1450,127819,98291,85076,13215,15.5,2020-08-24
1449,127819,97899,88574,9325,10.5,2020-08-25
1448,127819,97951,89091,8860,9.9,2020-08-26
1447,127819,98377,84961,13416,15.8,2020-08-27
1446,128078,98247,85677,12570,14.7,2020-08-28
1445,128078,94365,72836,21529,29.6,2020-08-29
1444,128078,97818,71466,26352,36.9,2020-08-30
1443,128078,98469,82673,15796,19.1,2020-08-31
1442,128078,96797,82036,14761,18.0,2020-09-01
1441,128078,96522,81356,15166,18.6,2020-09-02
1440,128078,93299,74636,18663,25.0,2020-09-03
1439,128078,92606,73772,18834,25.5,2020-09-04
1438,128078,88098,61835,26263,42.5,2020-09-05
1437,128078,91524,59566,31958,53.7,2020-09-06
1436,128078,90928,69547,21381,30.7,2020-09-07
1435,128078,91007,73153,17854,24.4,2020-09-08
1434,128078,90356,71515,18841,26.3,2020-09-09
1433,128078,89827,72738,17089,23.5,2020-09-10
1432,128078,89004,73473,15531,21.1,2020-09-11
1431,128078,85586,60966,24620,40.4,2020-09-12
1430,128078,86405,59480,26925,45.3,2020-09-13
1429,128078,88674,70702,17972,25.4,2020-09-14
1428,128078,87732,73146,14586,19.9,2020-09-15
1427,128078,87437,73144,14293,19.5,2020-09-16
1426,128078,88228,71725,16503,23.0,2020-09-17
1425,128078,89897,68259,21638,31.7,2020-09-18
1424,128078,84851,59888,24963,41.7,2020-09-19
1423,128078,87008,58261,28747,49.3,2020-09-20
1422,128078,85529,67626,17903,26.5,2020-09-21
1421,128078,85522,68157,17365,25.5,2020-09-22
1420,128078,85480,68298,17182,25.2,2020-09-23
1419,128078,85023,69151,15872,23.0,2020-09-24
1418,128562,83744,67826,15918,23.5,2020-09-25
1417,128562,82264,59397,22867,38.5,2020-09-26
1416,128562,84816,58397,26419,45.2,2020-09-27
1415,128562,86570,66036,20534,31.1,2020-09-28
1414,128562,85624,60187,25437,42.3,2020-09-29
1413,128562,85437,51986,33451,64.3,2020-09-30
1412,128562,83392,48946,34446,70.4,2020-10-01
1411,128562,83813,51651,32162,62.3,2020-10-02
1410,128562,83911,53653,30258,56.4,2020-10-03
1409,128562,84967,55638,29329,52.7,2020-10-04
1408,128562,82923,65238,17685,27.1,2020-10-05
1407,128562,83948,66935,17013,25.4,2020-10-06
1406,128562,83795,66722,17073,25.6,2020-10-07
1405,128562,85846,66261,19585,29.6,2020-10-08
1404,128562,84994,62608,22386,35.8,2020-10-09
1403,128562,85805,57877,27928,48.3,2020-10-10
1402,128562,87356,57139,30217,52.9,2020-10-11
1401,128562,87545,67195,20350,30.3,2020-10-12
1400,128562,87140,67755,19385,28.6,2020-10-13
1399,128562,87900,67364,20536,30.5,2020-10-14
1398,128562,87965,67771,20194,29.8,2020-10-15
1397,128562,88445,67349,21096,31.3,2020-10-16
1396,128562,86170,59231,26939,45.5,2020-10-17
1395,128562,86593,57306,29287,51.1,2020-10-18
1394,128562,86637,67545,19092,28.3,2020-10-19
1393,127762,86336,67824,18512,27.3,2020-10-20
1392,127762,85999,68454,17545,25.6,2020-10-21
1391,127762,86805,68374,18431,27.0,2020-10-22
1390,127762,88205,67147,21058,31.4,2020-10-23
1389,127762,87472,59213,28259,47.7,2020-10-24
1388,127762,86531,57288,29243,51.0,2020-10-25
1387,127762,85565,67680,17885,26.4,2020-10-26
1386,127762,83430,67660,15770,23.3,2020-10-27
1385,127762,84286,66752,17534,26.3,2020-10-28
1384,128197,86310,67410,18900,28.0,2020-10-29
1383,128197,87749,66037,21712,32.9,2020-10-30
1382,128197,83503,57719,25784,44.7,2020-10-31
1381,128197,82297,56822,25475,44.8,2020-11-01
1380,128197,83707,66720,16987,25.5,2020-11-02
1379,128197,84039,69570,14469,20.8,2020-11-03
1378,128197,84201,69231,14970,21.6,2020-11-04
1377,128197,84703,68907,15796,22.9,2020-11-05
1376,128197,86273,69596,16677,24.0,2020-11-06
1375,128197,86552,58540,28012,47.9,2020-11-07
1374,128197,88167,57536,30631,53.2,2020-11-08
1373,128197,87391,69999,17392,24.8,2020-11-09
1372,128197,87738,68952,18786,27.2,2020-11-10
1371,128197,86307,67954,18353,27.0,2020-11-11
1370,128197,86645,68011,18634,27.4,2020-11-12
1369,128197,85827,67692,18135,26.8,2020-11-13
1368,128197,85450,58858,26592,45.2,2020-11-14
1367,128197,86174,57555,28619,49.7,2020-11-15
1366,128197,84560,68154,16406,24.1,2020-11-16
1365,128197,87217,69082,18135,26.3,2020-11-17
1364,128197,88630,69555,19075,27.4,2020-11-18
1363,128197,87933,70905,17028,24.0,2020-11-19
1362,128197,89056,71916,17140,23.8,2020-11-20
1361,128197,90106,60121,29985,49.9,2020-11-21
1360,128197,91702,59194,32508,54.9,2020-11-22
1359,128197,90650,73234,17416,23.8,2020-11-23
1358,128197,92402,73988,18414,24.9,2020-11-24
1357,128197,93638,72888,20750,28.5,2020-11-25
1356,128197,91860,73798,18062,24.5,2020-11-26
1355,128609,95242,73588,21654,29.4,2020-11-27
1354,128609,94835,63912,30923,48.4,2020-11-28
1353,128609,94989,62162,32827,52.8,2020-11-29
1352,128609,96827,77074,19753,25.6,2020-11-30
1351,128609,89162,76210,12952,17.0,2020-12-01
1350,128609,90125,77722,12403,16.0,2020-12-02
1349,128609,90134,76904,13230,17.2,2020-12-03
1348,128609,90619,76916,13703,17.8,2020-12-04
1347,128609,87545,64555,22990,35.6,2020-12-05
1346,128609,86824,62314,24510,39.3,2020-12-06
1345,128609,89207,78832,10375,13.2,2020-12-07
1344,128609,90949,78234,12715,16.3,2020-12-08
1343,128609,92162,78544,13618,17.3,2020-12-09
1342,128609,91022,80497,10525,13.1,2020-12-10
1341,128609,91288,77669,13619,17.5,2020-12-11
1340,128609,88706,64485,24221,37.6,2020-12-12
1339,128609,90985,63683,27302,42.9,2020-12-13
1338,128609,96126,84182,11944,14.2,2020-12-14
1337,128609,97585,84708,12877,15.2,2020-12-15
1336,128609,98795,85132,13663,16.0,2020-12-16
1335,128609,97476,84185,13291,15.8,2020-12-17
1334,128609,97067,82899,14168,17.1,2020-12-18
1333,128609,94556,69628,24928,35.8,2020-12-19
1332,128609,92484,66560,25924,38.9,2020-12-20
1331,128609,95863,82906,12957,15.6,2020-12-21
1330,128609,94909,82109,12800,15.6,2020-12-22
1329,128609,96337,81349,14988,18.4,2020-12-23
1328,128609,94665,77124,17541,22.7,2020-12-24
1327,128609,94583,67327,27256,40.5,2020-12-25
1326,128609,92990,63604,29386,46.2,2020-12-26
1325,128609,92923,62840,30083,47.9,2020-12-27
1324,128609,96902,76803,20099,26.2,2020-12-28
1323,129191,98175,78915,19260,24.4,2020-12-29
1322,129191,99290,83916,15374,18.3,2020-12-30
1321,129191,99506,80632,18874,23.4,2020-12-31
1320,128209,98477,64942,33535,51.6,2021-01-01
1319,128209,97800,64982,32818,50.5,2021-01-02
1318,128209,96591,66473,30118,45.3,2021-01-03
1317,128209,97246,82840,14406,17.4,2021-01-04
1316,128209,97905,84497,13408,15.9,2021-01-05
1315,128209,98015,85568,12447,14.5,2021-01-06
1314,128209,98213,90195,8018,8.9,2021-01-07
1313,128209,98229,89858,8371,9.3,2021-01-08
1312,128209,92949,74232,18717,25.2,2021-01-09
1311,128209,92072,70738,21334,30.2,2021-01-10
1310,128209,99189,90564,8625,9.5,2021-01-11
1309,128209,98911,88089,10822,12.3,2021-01-12
1308,128209,97325,84235,13090,15.5,2021-01-13
1307,128209,97618,80757,16861,20.9,2021-01-14
1306,128209,97229,78869,18360,23.3,2021-01-15
1305,128209,95981,69347,26634,38.4,2021-01-16
1304,128209,96509,68310,28199,41.3,2021-01-17
1303,128209,100962,86673,14289,16.5,2021-01-18
1302,128209,101789,85348,16441,19.3,2021-01-19
1301,128209,99678,83468,16210,19.4,2021-01-20
1300,128209,98432,80435,17997,22.4,2021-01-21
1299,128209,97449,79367,18082,22.8,2021-01-22
1298,128209,93433,65370,28063,42.9,2021-01-23
1297,128209,95387,62201,33186,53.4,2021-01-24
1296,128209,99244,75047,24197,32.2,2021-01-25
1295,128209,98918,79190,19728,24.9,2021-01-26
1294,128209,98753,77213,21540,27.9,2021-01-27
1293,128820,99431,80655,18776,23.3,2021-01-28
1292,128820,100187,83971,16216,19.3,2021-01-29
1291,128820,97640,69215,28425,41.1,2021-01-30
1290,128820,97006,63574,33432,52.6,2021-01-31
1289,128820,97244,77878,19366,24.9,2021-02-01
1288,128820,100311,80457,19854,24.7,2021-02-02
1287,128820,98639,82594,16045,19.4,2021-02-03
1286,128820,99356,80804,18552,23.0,2021-02-04
1285,128820,98078,80698,17380,21.5,2021-02-05
1284,128820,95591,66340,29251,44.1,2021-02-06
1283,128820,97339,63698,33641,52.8,2021-02-07
1282,128820,95887,77950,17937,23.0,2021-02-08
1281,128820,95302,79114,16188,20.5,2021-02-09
1280,128820,95532,76269,19263,25.3,2021-02-10
1279,128820,92479,61009,31470,51.6,2021-02-11
1278,128820,86404,54836,31568,57.6,2021-02-12
1277,128820,87762,55686,32076,57.6,2021-02-13
1276,128820,88705,57687,31018,53.8,2021-02-14
1275,128820,94473,74829,19644,26.3,2021-02-15
1274,128820,95044,80711,14333,17.8,2021-02-16
1273,128820,95992,84749,11243,13.3,2021-02-17
1272,128820,96048,84067,11981,14.3,2021-02-18
1271,128820,95171,79299,15872,20.0,2021-02-19
1270,128820,91578,64603,26975,41.8,2021-02-20
1269,128820,90791,60140,30651,51.0,2021-02-21
1268,128820,95782,70422,25360,36.0,2021-02-22
1267,128820,96003,73896,22107,29.9,2021-02-23
1266,128820,94726,76281,18445,24.2,2021-02-24
1265,128820,94462,77701,16761,21.6,2021-02-25
1264,128820,93769,73253,20516,28.0,2021-02-26
1263,128820,90533,61810,28723,46.5,2021-02-27
1262,128820,87376,59511,27865,46.8,2021-02-28
1261,128820,91305,64904,26401,40.7,2021-03-01
1260,128820,92526,77208,15318,19.8,2021-03-02
1259,128820,90347,74748,15599,20.9,2021-03-03
1258,129114,92010,76597,15413,20.1,2021-03-04
1257,129114,90815,72682,18133,24.9,2021-03-05
1256,129114,86139,62607,23532,37.6,2021-03-06
1255,129114,86687,60702,25985,42.8,2021-03-07
1254,129114,90377,71789,18588,25.9,2021-03-08
1253,129114,90638,72893,17745,24.3,2021-03-09
1252,129114,90175,70943,19232,27.1,2021-03-10
1251,129114,89685,71172,18513,26.0,2021-03-11
1250,129114,89744,73861,15883,21.5,2021-03-12
1249,129114,83969,60715,23254,38.3,2021-03-13
1248,129114,84416,58921,25495,43.3,2021-03-14
1247,129114,89907,68220,21687,31.8,2021-03-15
1246,129114,89360,68547,20813,30.4,2021-03-16
1245,129114,88514,67684,20830,30.8,2021-03-17
1244,129114,87913,68081,19832,29.1,2021-03-18
1243,129114,87313,67369,19944,29.6,2021-03-19
1242,129114,84474,61460,23014,37.4,2021-03-20
1241,129114,85076,59578,25498,42.8,2021-03-21
1240,129114,85853,68873,16980,24.7,2021-03-22
1239,129114,86642,68079,18563,27.3,2021-03-23
1238,129114,86499,68196,18303,26.8,2021-03-24
1237,129114,86425,67429,18996,28.2,2021-03-25
1236,129114,86356,66019,20337,30.8,2021-03-26
1235,129114,79683,59268,20415,34.4,2021-03-27
1234,129114,80393,57877,22516,38.9,2021-03-28
1233,129114,84735,66819,17916,26.8,2021-03-29
1232,129114,85885,66325,19560,29.5,2021-03-30
1231,129114,87055,65755,21300,32.4,2021-03-31
1230,129361,86161,66192,19969,30.2,2021-04-01
1229,129361,86166,64600,21566,33.4,2021-04-02
1228,129361,81169,59025,22144,37.5,2021-04-03
1227,129361,77428,57780,19648,34.0,2021-04-04
1226,129361,78663,66231,12432,18.8,2021-04-05
1225,129361,76858,66622,10236,15.4,2021-04-06
1224,129361,77395,66289,11106,16.8,2021-04-07
1223,129361,78093,66706,11387,17.1,2021-04-08
1222,129361,77866,65500,12366,18.9,2021-04-09
1221,129361,77769,58226,19543,33.6,2021-04-10
1220,129361,77347,56651,20696,36.5,2021-04-11
1219,129361,77695,68966,8729,12.7,2021-04-12
1218,129361,79998,66770,13228,19.8,2021-04-13
1217,129361,79298,66263,13035,19.7,2021-04-14
1216,129361,79439,66365,13074,19.7,2021-04-15
1215,129361,80181,66009,14172,21.5,2021-04-16
1214,129361,79926,58589,21337,36.4,2021-04-17
1213,129361,79970,57397,22573,39.3,2021-04-18
1212,129361,81777,66072,15705,23.8,2021-04-19
1211,129361,80715,66393,14322,21.6,2021-04-20
1210,129361,80595,65940,14655,22.2,2021-04-21
1209,129361,79141,67265,11876,17.7,2021-04-22
1208,129361,80306,65461,14845,22.7,2021-04-23
1207,129361,75978,57782,18196,31.5,2021-04-24
1206,129361,77491,56810,20681,36.4,2021-04-25
1205,129361,77474,65456,12018,18.4,2021-04-26
1204,129361,78696,66283,12413,18.7,2021-04-27
1203,129361,79141,65551,13590,20.7,2021-04-28
1202,129361,79393,66022,13371,20.3,2021-04-29
1201,129361,78607,64304,14303,22.2,2021-04-30
1200,128441,77837,56758,21079,37.1,2021-05-01
1199,128441,75699,56721,18978,33.5,2021-05-02
1198,128441,77344,65471,11873,18.1,2021-05-03
1197,128441,79297,67838,11459,16.9,2021-05-04
1196,128441,80360,60540,19820,32.7,2021-05-05
1195,128441,80063,65436,14627,22.4,2021-05-06
1194,128441,80942,64780,16162,24.9,2021-05-07
1193,128441,80119,57311,22808,39.8,2021-05-08
1192,128441,78634,56138,22496,40.1,2021-05-09
1191,128441,78224,66682,11542,17.3,2021-05-10
1190,128441,79515,66134,13381,20.2,2021-05-11
1189,128441,76910,66063,10847,16.4,2021-05-12
1188,128441,77778,67558,10220,15.1,2021-05-13
1187,129540,78939,68888,10051,14.6,2021-05-14
1186,129540,74083,60555,13528,22.3,2021-05-15
1185,129540,73597,58503,15094,25.8,2021-05-16
1184,129540,78759,68368,10391,15.2,2021-05-17
1183,129540,80516,66240,14276,21.6,2021-05-18
1182,129540,77651,62006,15645,25.2,2021-05-19
1181,129540,80387,69140,11247,16.3,2021-05-20
1180,129540,78706,65806,12900,19.6,2021-05-21
1179,129540,78969,58452,20517,35.1,2021-05-22
1178,129540,78777,56815,21962,38.7,2021-05-23
1177,129540,80691,65847,14844,22.5,2021-05-24
1176,129540,82567,65408,17159,26.2,2021-05-25
1175,129540,82817,66876,15941,23.8,2021-05-26
1174,129540,81164,67738,13426,19.8,2021-05-27
1173,129623,81180,66069,15111,22.9,2021-05-28
1172,129623,80035,57782,22253,38.5,2021-05-29
1171,129623,81534,57041,24493,42.9,2021-05-30
1170,129623,82530,66049,16481,25.0,2021-05-31
1169,129623,81585,67332,14253,21.2,2021-06-01
1168,129623,80613,68419,12194,17.8,2021-06-02
1167,129623,79984,70113,9871,14.1,2021-06-03
1166,129623,80802,64864,15938,24.6,2021-06-04
1165,129623,80179,58611,21568,36.8,2021-06-05
1164,129623,80130,58683,21447,36.5,2021-06-06
1163,129623,80238,68543,11695,17.1,2021-06-07
1162,129623,81135,69828,11307,16.2,2021-06-08
1161,129623,85738,73387,12351,16.8,2021-06-09
1160,129623,84887,74929,9958,13.3,2021-06-10
1159,129623,84857,70071,14786,21.1,2021-06-11
1158,129623,81677,62209,19468,31.3,2021-06-12
1157,129623,83336,61518,21818,35.5,2021-06-13
1156,129623,85516,74220,11296,15.2,2021-06-14
1155,129623,84765,73311,11454,15.6,2021-06-15
1154,129623,86430,72494,13936,19.2,2021-06-16
1153,129623,84780,72670,12110,16.7,2021-06-17
1152,129623,85313,70527,14786,21.0,2021-06-18
1151,129623,80496,60923,19573,32.1,2021-06-19
1150,129623,81141,61200,19941,32.6,2021-06-20
1149,129623,85494,72382,13112,18.1,2021-06-21
1148,129623,86284,72518,13766,19.0,2021-06-22
1147,129623,86980,71726,15254,21.3,2021-06-23
1146,129623,83428,72813,10615,14.6,2021-06-24
1145,129623,84448,72763,11685,16.1,2021-06-25
1144,129623,82911,62042,20869,33.6,2021-06-26
1143,129623,82726,62109,20617,33.2,2021-06-27
1142,129623,86121,74821,11300,15.1,2021-06-28
1141,129623,87573,75854,11719,15.4,2021-06-29
1140,131069,87887,74824,13063,17.5,2021-06-30
1139,131069,94268,77476,16792,21.7,2021-07-01
1138,131069,93498,76865,16633,21.6,2021-07-02
1137,131069,90140,64612,25528,39.5,2021-07-03
1136,131069,93065,62368,30697,49.2,2021-07-04
1135,131069,95897,76256,19641,25.8,2021-07-05
1134,131069,94417,79663,14754,18.5,2021-07-06
1133,131069,95298,81086,14212,17.5,2021-07-07
1132,131069,96234,81187,15047,18.5,2021-07-08
1131,131069,95686,78397,17289,22.1,2021-07-09
1130,131069,93577,67726,25851,38.2,2021-07-10
1129,131069,93247,68518,24729,36.1,2021-07-11
1128,131069,95006,85011,9995,11.8,2021-07-12
1127,131069,95966,87172,8794,10.1,2021-07-13
1126,131069,97475,88087,9388,10.7,2021-07-14
1125,131069,98180,88551,9629,10.9,2021-07-15
1124,131069,97850,88015,9835,11.2,2021-07-16
1123,131069,91582,71849,19733,27.5,2021-07-17
1122,131069,90453,72054,18399,25.5,2021-07-18
1121,131069,98755,84586,14169,16.8,2021-07-19
1120,131069,98376,87841,10535,12.0,2021-07-20
1119,131069,99657,88937,10720,12.1,2021-07-21
1118,131330,99955,89958,9997,11.1,2021-07-22
1117,131330,99758,89812,9946,11.1,2021-07-23
1116,131330,94507,78285,16222,20.7,2021-07-24
1115,131330,95777,76521,19256,25.2,2021-07-25
1114,131330,100633,89426,11207,12.5,2021-07-26
1113,131330,100739,91141,9598,10.5,2021-07-27
1112,131330,100846,90240,10606,11.8,2021-07-28
1111,131330,101071,89634,11437,12.8,2021-07-29
1110,131330,99390,87847,11543,13.1,2021-07-30
1109,131330,92532,76776,15756,20.5,2021-07-31
1108,131330,93539,72943,20596,28.2,2021-08-01
1107,131330,98974,75460,23514,31.2,2021-08-02
1106,131330,100181,77517,22664,29.2,2021-08-03
1105,131330,99578,80073,19505,24.4,2021-08-04
1104,131330,99341,85215,14126,16.6,2021-08-05
1103,131330,99799,82367,17432,21.2,2021-08-06
1102,131330,94901,75210,19691,26.2,2021-08-07
1101,131330,94736,70201,24535,34.9,2021-08-08
1100,131330,100772,84755,16017,18.9,2021-08-09
1099,131330,100834,84877,15957,18.8,2021-08-10
1098,131330,100800,83818,16982,20.3,2021-08-11
1097,131330,98952,86355,12597,14.6,2021-08-12
1096,131330,100125,81779,18346,22.4,2021-08-13
1095,131330,96246,68470,27776,40.6,2021-08-14
1094,131330,95825,68076,27749,40.8,2021-08-15
1093,131330,95165,74559,20606,27.6,2021-08-16
1092,131330,100178,80393,19785,24.6,2021-08-17
1091,131330,99241,80362,18879,23.5,2021-08-18
1090,131330,99622,79472,20150,25.4,2021-08-19
1089,131330,100721,79554,21167,26.6,2021-08-20
1088,131330,95487,69215,26272,38.0,2021-08-21
1087,131330,94493,66387,28106,42.3,2021-08-22
1086,131330,98884,79334,19550,24.6,2021-08-23
1085,131650,99256,81241,18015,22.2,2021-08-24
1084,131650,97998,80262,17736,22.1,2021-08-25
1083,131650,99284,81471,17813,21.9,2021-08-26
1082,131650,99432,78339,21093,26.9,2021-08-27
1081,131650,94472,66357,28115,42.4,2021-08-28
1080,131650,95099,65588,29511,45.0,2021-08-29
1079,131650,99798,78996,20802,26.3,2021-08-30
1078,131650,100757,77665,23092,29.7,2021-08-31
1077,131650,98658,77228,21430,27.7,2021-09-01
1076,131650,98606,76036,22570,29.7,2021-09-02
1075,131650,99017,74073,24944,33.7,2021-09-03
1074,131650,92603,63885,28718,45.0,2021-09-04
1073,131650,91917,62545,29372,47.0,2021-09-05
1072,131650,95624,75426,20198,26.8,2021-09-06
1071,131650,93587,76075,17512,23.0,2021-09-07
1070,131650,95992,74423,21569,29.0,2021-09-08
1069,131895,95161,76594,18567,24.2,2021-09-09
1068,131895,94120,75304,18816,25.0,2021-09-10
1067,131895,88890,65783,23107,35.1,2021-09-11
1066,131895,90272,64512,25760,39.9,2021-09-12
1065,131895,90532,77820,12712,16.3,2021-09-13
1064,131895,90371,76081,14290,18.8,2021-09-14
1063,131895,90836,74944,15892,21.2,2021-09-15
1062,131895,88754,75436,13318,17.7,2021-09-16
1061,131895,88469,71837,16632,23.2,2021-09-17
1060,131895,84328,62245,22083,35.5,2021-09-18
1059,131895,84130,58954,25176,42.7,2021-09-19
1058,131895,84913,55779,29134,52.2,2021-09-20
1057,131895,85539,53652,31887,59.4,2021-09-21
1056,131895,85961,57177,28784,50.3,2021-09-22
1055,131895,82499,67149,15350,22.9,2021-09-23
1054,131895,81455,68879,12576,18.3,2021-09-24
1053,131895,80070,61851,18219,29.5,2021-09-25
1052,131895,81338,60737,20601,33.9,2021-09-26
1051,131895,82653,72396,10257,14.2,2021-09-27
1050,131895,82881,74094,8787,11.9,2021-09-28
1049,131895,84542,75683,8859,11.7,2021-09-29
1048,131895,83670,73226,10444,14.3,2021-09-30
1047,131895,83684,72146,11538,16.0,2021-10-01
1046,131895,74989,62298,12691,20.4,2021-10-02
1045,131895,74037,60876,13161,21.6,2021-10-03
1044,131895,78098,69932,8166,11.7,2021-10-04
1043,131895,82449,75698,6751,8.9,2021-10-05
1042,132113,83917,73845,10072,13.6,2021-10-06
1041,132113,82862,73754,9108,12.3,2021-10-07
1040,132113,83473,72717,10756,14.8,2021-10-08
1039,132113,79238,63659,15579,24.5,2021-10-09
1038,132113,80249,61162,19087,31.2,2021-10-10
1037,132113,81058,64647,16411,25.4,2021-10-11
1036,132113,83052,70121,12931,18.4,2021-10-12
1035,132113,81390,70657,10733,15.2,2021-10-13
1034,132113,80638,71458,9180,12.8,2021-10-14
1033,132113,78551,70778,7773,11.0,2021-10-15
1032,132113,79999,60050,19949,33.2,2021-10-16
1031,132113,79452,58640,20812,35.5,2021-10-17
1030,132113,81221,69348,11873,17.1,2021-10-18
1029,132113,81211,69823,11388,16.3,2021-10-19
1028,132113,80245,69414,10831,15.6,2021-10-20
1027,132113,81902,70203,11699,16.7,2021-10-21
1026,132113,85343,67900,17443,25.7,2021-10-22
1025,132113,81426,59042,22384,37.9,2021-10-23
1024,132113,80298,57699,22599,39.2,2021-10-24
1023,132113,83115,69114,14001,20.3,2021-10-25
1022,132113,83798,69601,14197,20.4,2021-10-26
1021,132113,83310,68937,14373,20.8,2021-10-27
1020,132113,82479,69488,12991,18.7,2021-10-28
1019,132113,84869,67683,17186,25.4,2021-10-29
1018,133455,82627,59770,22857,38.2,2021-10-30
1017,133455,83019,58161,24858,42.7,2021-10-31
1016,133455,85827,69259,16568,23.9,2021-11-01
1015,133455,85478,69554,15924,22.9,2021-11-02
1014,133455,83854,69599,14255,20.5,2021-11-03
1013,133455,84334,70149,14185,20.2,2021-11-04
1012,133455,84602,68742,15860,23.1,2021-11-05
1011,133455,78785,59456,19329,32.5,2021-11-06
1010,133455,80184,58370,21814,37.4,2021-11-07
1009,133455,86547,72602,13945,19.2,2021-11-08
1008,133455,84443,72800,11643,16.0,2021-11-09
1007,133455,84601,73477,11124,15.1,2021-11-10
1006,133564,85839,74708,11131,14.9,2021-11-11
1005,133564,85381,73855,11526,15.6,2021-11-12
1004,133564,82198,61840,20358,32.9,2021-11-13
1003,133564,80771,59863,20908,34.9,2021-11-14
1002,133564,84114,71603,12511,17.5,2021-11-15
1001,133564,84252,72310,11942,16.5,2021-11-16
1000,133564,85564,73028,12536,17.2,2021-11-17
999,133564,84890,72485,12405,17.1,2021-11-18
998,133564,85565,70926,14639,20.6,2021-11-19
997,133564,82811,61390,21421,34.9,2021-11-20
996,133564,80551,60516,20035,33.1,2021-11-21
995,133564,88726,76847,11879,15.5,2021-11-22
994,133564,91056,79838,11218,14.1,2021-11-23
993,133564,93131,76210,16921,22.2,2021-11-24
992,133564,95904,74510,21394,28.7,2021-11-25
991,133564,96502,75223,21279,28.3,2021-11-26
990,133564,92026,63937,28089,43.9,2021-11-27
989,133564,91146,62027,29119,46.9,2021-11-28
988,133564,94302,75340,18962,25.2,2021-11-29
987,133564,95394,80362,15032,18.7,2021-11-30
986,133564,96460,81177,15283,18.8,2021-12-01
985,133896,95116,80145,14971,18.7,2021-12-02
984,133896,96839,78696,18143,23.1,2021-12-03
983,133896,94435,65770,28665,43.6,2021-12-04
982,133896,93599,64032,29567,46.2,2021-12-05
981,133896,100061,78083,21978,28.1,2021-12-06
980,133896,100638,78079,22559,28.9,2021-12-07
979,133896,100449,78310,22139,28.3,2021-12-08
978,133896,100769,78182,22587,28.9,2021-12-09
977,133896,100525,77936,22589,29.0,2021-12-10
976,133896,94870,64834,30036,46.3,2021-12-11
975,133896,98173,65441,32732,50.0,2021-12-12
974,133896,102797,82173,20624,25.1,2021-12-13
973,133896,101254,82571,18683,22.6,2021-12-14
972,133896,100450,79839,20611,25.8,2021-12-15
971,133896,99929,81399,18530,22.8,2021-12-16
970,133896,104301,85699,18602,21.7,2021-12-17
969,133896,98106,70883,27223,38.4,2021-12-18
968,133896,99975,67544,32431,48.0,2021-12-19
967,133896,102725,81750,20971,25.7,2021-12-20
966,134012,101328,80294,21034,26.2,2021-12-21
965,134012,101750,81451,20299,24.9,2021-12-22
964,134012,102837,81874,20963,25.6,2021-12-23
963,134012,101856,81185,20671,25.5,2021-12-24
962,134158,101662,72815,28847,39.6,2021-12-25
961,134158,101244,71719,29525,41.2,2021-12-26
960,134158,103554,90708,12846,14.2,2021-12-27
959,134158,101789,88717,13072,14.7,2021-12-28
958,134158,103867,85966,17901,20.8,2021-12-29
957,134158,105343,84564,20779,24.6,2021-12-30
956,134158,105752,81748,24004,29.4,2021-12-31
955,134020,101222,67369,33853,50.3,2022-01-01
954,134020,103896,68173,35723,52.4,2022-01-02
953,134020,107391,85196,22195,26.1,2022-01-03
952,134020,106705,85161,21544,25.3,2022-01-04
951,134020,107631,89397,18234,20.4,2022-01-05
950,134020,107486,84761,22725,26.8,2022-01-06
949,134020,107169,85425,21744,25.5,2022-01-07
948,134020,102853,70793,32060,45.3,2022-01-08
947,134020,101437,67889,33548,49.4,2022-01-09
946,134020,104076,85301,18775,22.0,2022-01-10
945,134020,107504,88103,19401,22.0,2022-01-11
944,134020,107063,88305,18758,21.2,2022-01-12
943,134020,107327,89115,18212,20.4,2022-01-13
942,134020,106463,87278,19185,22.0,2022-01-14
941,134020,99046,71585,27461,38.4,2022-01-15
940,134020,99043,70090,28953,41.3,2022-01-16
939,134020,104610,87967,16643,18.9,2022-01-17
938,134020,104684,87579,17105,19.5,2022-01-18
937,134020,104860,88076,16784,19.1,2022-01-19
936,134020,105164,87884,17280,19.7,2022-01-20
935,134020,104526,86522,18004,20.8,2022-01-21
934,134020,99165,72105,27060,37.5,2022-01-22
933,134020,100014,67726,32288,47.7,2022-01-23
932,134020,103205,83085,20120,24.2,2022-01-24
931,134123,102737,86241,16496,19.1,2022-01-25
930,134123,103430,82984,20446,24.6,2022-01-26
929,134123,103391,82938,20453,24.7,2022-01-27
928,134123,104633,82283,22350,27.2,2022-01-28
927,134123,98753,68009,30744,45.2,2022-01-29
926,134123,95905,65026,30879,47.5,2022-01-30
925,134123,95850,61339,34511,56.3,2022-01-31
924,133069,97064,59840,37224,62.2,2022-02-01
923,133069,99458,63795,35663,55.9,2022-02-02
922,133069,102205,78841,23364,29.6,2022-02-03
921,133069,102340,82614,19726,23.9,2022-02-04
920,133069,100908,73089,27819,38.1,2022-02-05
919,133069,100922,69718,31204,44.8,2022-02-06
918,133069,100103,87351,12752,14.6,2022-02-07
917,133069,102163,85352,16811,19.7,2022-02-08
916,133069,101527,83819,17708,21.1,2022-02-09
915,133069,103674,81626,22048,27.0,2022-02-10
914,133069,102618,81928,20690,25.3,2022-02-11
913,133069,100573,67542,33031,48.9,2022-02-12
912,133069,100238,65396,34842,53.3,2022-02-13
911,133069,103073,79225,23848,30.1,2022-02-14
910,133069,104682,83893,20789,24.8,2022-02-15
909,133069,103942,86687,17255,19.9,2022-02-16
908,133069,103184,86434,16750,19.4,2022-02-17
907,133069,100716,84164,16552,19.7,2022-02-18
906,133069,98848,70632,28216,39.9,2022-02-19
905,133069,96907,69627,27280,39.2,2022-02-20
904,133069,97347,82900,14447,17.4,2022-02-21
903,133069,96702,83248,13454,16.2,2022-02-22
902,133069,98038,85489,12549,14.7,2022-02-23
901,133069,97557,83453,14104,16.9,2022-02-24
900,133069,98432,80824,17608,21.8,2022-02-25
899,133069,97176,67374,29802,44.2,2022-02-26
898,133069,95229,64965,30264,46.6,2022-02-27
897,133069,91911,73959,17952,24.3,2022-02-28
896,133069,92392,69920,22472,32.1,2022-03-01
895,133069,93798,77502,16296,21.0,2022-03-02
894,133069,91888,77182,14706,19.1,2022-03-03
893,133069,89526,78189,11337,14.5,2022-03-04
892,133069,82102,66375,15727,23.7,2022-03-05
891,133069,81233,64675,16558,25.6,2022-03-06
890,133069,88990,77345,11645,15.1,2022-03-07
889,133561,90369,76762,13607,17.7,2022-03-08
888,133561,92928,67781,25147,37.1,2022-03-09
887,133561,93595,73841,19754,26.8,2022-03-10
886,133561,91552,74509,17043,22.9,2022-03-11
885,133561,83382,62114,21268,34.2,2022-03-12
884,133561,83055,61436,21619,35.2,2022-03-13
883,133561,91813,76789,15024,19.6,2022-03-14
882,133561,92568,71988,20580,28.6,2022-03-15
881,133561,87501,70966,16535,23.3,2022-03-16
880,133561,87346,75585,11761,15.6,2022-03-17
879,133561,89903,76980,12923,16.8,2022-03-18
878,133561,84686,66838,17848,26.7,2022-03-19
877,133561,83653,62882,20771,33.0,2022-03-20
876,133561,86078,74381,11697,15.7,2022-03-21
875,133561,86161,73197,12964,17.7,2022-03-22
874,133561,89033,78233,10800,13.8,2022-03-23
873,133561,83716,73156,10560,14.4,2022-03-24
872,133561,84019,71135,12884,18.1,2022-03-25
871,133561,78264,62291,15973,25.6,2022-03-26
870,133561,81196,60623,20573,33.9,2022-03-27
869,133561,83826,70765,13061,18.5,2022-03-28
868,133561,83223,70311,12912,18.4,2022-03-29
867,133561,83144,71112,12032,16.9,2022-03-30
866,133561,83397,70618,12779,18.1,2022-03-31
865,133561,86929,68838,18091,26.3,2022-04-01
864,133561,81417,61732,19685,31.9,2022-04-02
863,133561,81121,60331,20790,34.5,2022-04-03
862,133561,84320,69891,14429,20.6,2022-04-04
861,133561,84085,70446,13639,19.4,2022-04-05
860,133561,83820,69222,14598,21.1,2022-04-06
859,133561,84039,69860,14179,20.3,2022-04-07
858,133680,84389,67293,17096,25.4,2022-04-08
857,133680,78558,60137,18421,30.6,2022-04-09
856,133680,79188,58490,20698,35.4,2022-04-10
855,133680,83037,68821,14216,20.7,2022-04-11
854,133680,84159,69958,14201,20.3,2022-04-12
853,133680,84457,71879,12578,17.5,2022-04-13
852,133680,84050,71334,12716,17.8,2022-04-14
851,133680,83940,67132,16808,25.0,2022-04-15
850,133680,77102,59944,17158,28.6,2022-04-16
849,133680,77578,58749,18829,32.0,2022-04-17
848,133680,80747,67906,12841,18.9,2022-04-18
847,133680,82152,68498,13654,19.9,2022-04-19
846,133680,82087,67702,14385,21.2,2022-04-20
845,133680,82006,68547,13459,19.6,2022-04-21
844,133680,82377,67015,15362,22.9,2022-04-22
843,133680,77509,58909,18600,31.6,2022-04-23
842,133680,77599,58501,19098,32.6,2022-04-24
841,133680,82516,69646,12870,18.5,2022-04-25
840,133680,81625,69997,11628,16.6,2022-04-26
839,133680,83673,67404,16269,24.1,2022-04-27
838,133680,82861,68086,14775,21.7,2022-04-28
837,133680,83895,67684,16211,24.0,2022-04-29
836,133680,81336,58925,22411,38.0,2022-04-30
835,133680,80599,57624,22975,39.9,2022-05-01
834,133680,84804,67357,17447,25.9,2022-05-02
833,133680,85122,68221,16901,24.8,2022-05-03
832,133917,84671,66896,17775,26.6,2022-05-04
831,133917,82440,62398,20042,32.1,2022-05-05
830,133917,83815,65275,18540,28.4,2022-05-06
829,133917,74588,58240,16348,28.1,2022-05-07
828,133917,78693,57573,21120,36.7,2022-05-08
827,133917,82664,68295,14369,21.0,2022-05-09
826,133917,81916,68449,13467,19.7,2022-05-10
825,133917,82127,69284,12843,18.5,2022-05-11
824,133917,78815,69519,9296,13.4,2022-05-12
823,133917,81648,70215,11433,16.3,2022-05-13
822,133917,77018,59523,17495,29.4,2022-05-14
821,133917,80194,58322,21872,37.5,2022-05-15
820,133917,81117,68158,12959,19.0,2022-05-16
819,133917,78740,69598,9142,13.1,2022-05-17
818,133917,80022,69000,11022,16.0,2022-05-18
817,133917,78739,68981,9758,14.1,2022-05-19
816,133917,78019,68019,10000,14.7,2022-05-20
815,133917,73392,60962,12430,20.4,2022-05-21
814,133917,77792,60230,17562,29.2,2022-05-22
813,133917,81075,72122,8953,12.4,2022-05-23
812,133917,81847,72576,9271,12.8,2022-05-24
811,133917,82910,72539,10371,14.3,2022-05-25
810,133917,82378,69479,12899,18.6,2022-05-26
809,133917,82016,68961,13055,18.9,2022-05-27
808,133917,76955,61733,15222,24.7,2022-05-28
807,133917,79357,60948,18409,30.2,2022-05-29
806,133917,84474,73134,11340,15.5,2022-05-30
805,133917,84553,69888,14665,21.0,2022-05-31
804,134186,79189,64790,14399,22.2,2022-06-01
803,134186,83606,71717,11889,16.6,2022-06-02
802,134186,84094,72128,11966,16.6,2022-06-03
801,134186,82590,62408,20182,32.3,2022-06-04
800,134186,80301,58600,21701,37.0,2022-06-05
799,134186,83093,61814,21279,34.4,2022-06-06
798,134186,85109,70522,14587,20.7,2022-06-07
797,134060,85703,68480,17223,25.2,2022-06-08
796,134060,86254,69993,16261,23.2,2022-06-09
795,134060,85397,71317,14080,19.7,2022-06-10
794,134060,81919,62034,19885,32.1,2022-06-11
793,134060,82389,61303,21086,34.4,2022-06-12
792,134060,87376,71248,16128,22.6,2022-06-13
791,134060,86350,71477,14873,20.8,2022-06-14
790,134066,85748,69275,16473,23.8,2022-06-15
789,134066,85906,70925,14981,21.1,2022-06-16
788,134066,87896,73461,14435,19.6,2022-06-17
787,134066,85104,64277,20827,32.4,2022-06-18
786,134066,85859,64404,21455,33.3,2022-06-19
785,134066,87774,77816,9958,12.8,2022-06-20
784,134066,91094,81164,9930,12.2,2022-06-21
783,134092,91108,80941,10167,12.6,2022-06-22
782,134092,91404,83449,7955,9.5,2022-06-23
781,134092,92119,76118,16001,21.0,2022-06-24
780,134092,84436,69554,14882,21.4,2022-06-25
779,134092,86439,68906,17533,25.4,2022-06-26
778,134092,94364,84739,9625,11.4,2022-06-27
777,134092,93797,84057,9740,11.6,2022-06-28
776,134237,95432,84492,10940,12.9,2022-06-29
775,134237,93599,82731,10868,13.1,2022-06-30
774,134237,93231,83309,9922,11.9,2022-07-01
773,134237,88500,74974,13526,18.0,2022-07-02
772,134237,87495,74464,13031,17.5,2022-07-03
771,134237,99188,89337,9851,11.0,2022-07-04
770,134237,99463,90855,8608,9.5,2022-07-05
769,134239,99959,91938,8021,8.7,2022-07-06
768,134239,99716,92990,6726,7.2,2022-07-07
767,134239,99997,86475,13522,15.6,2022-07-08
766,134239,96076,75216,20860,27.7,2022-07-09
765,134239,96494,75168,21326,28.4,2022-07-10
764,134239,100015,86943,13072,15.0,2022-07-11
763,134239,99071,87250,11821,13.5,2022-07-12
762,134266,100299,85034,15265,18.0,2022-07-13
761,134266,100515,85530,14985,17.5,2022-07-14
760,134266,100653,83272,17381,20.9,2022-07-15
759,134266,96946,71327,25619,35.9,2022-07-16
758,134266,96711,70356,26355,37.5,2022-07-17
757,134266,97680,83578,14102,16.9,2022-07-18
756,134266,99472,84631,14841,17.5,2022-07-19
755,134269,99728,85756,13972,16.3,2022-07-20
754,134269,99835,82156,17679,21.5,2022-07-21
753,134269,100057,80509,19548,24.3,2022-07-22
752,134269,96461,70266,26195,37.3,2022-07-23
751,134269,96305,69817,26488,37.9,2022-07-24
750,134269,99610,84338,15272,18.1,2022-07-25
749,134269,100295,87347,12948,14.8,2022-07-26
748,134291,100687,85507,15180,17.8,2022-07-27
747,134291,100467,87405,13062,14.9,2022-07-28
746,134291,101383,87601,13782,15.7,2022-07-29
745,134291,96642,76651,19991,26.1,2022-07-30
744,134291,97211,72224,24987,34.6,2022-07-31
743,134291,99761,80055,19706,24.6,2022-08-01
742,134291,99741,77981,21760,27.9,2022-08-02
741,134417,100831,81174,19657,24.2,2022-08-03
740,134417,101790,85866,15924,18.5,2022-08-04
739,134417,102311,86550,15761,18.2,2022-08-05
738,134417,100321,80391,19930,24.8,2022-08-06
737,134417,100210,78998,21212,26.9,2022-08-07
736,134417,100691,89263,11428,12.8,2022-08-08
735,134417,100864,88479,12385,14.0,2022-08-09
734,134446,100922,85666,15256,17.8,2022-08-10
733,134446,100101,85488,14613,17.1,2022-08-11
732,134446,100802,85622,15180,17.7,2022-08-12
731,134446,95281,73971,21310,28.8,2022-08-13
730,134446,95386,74228,21158,28.5,2022-08-14
729,134446,99379,80123,19256,24.0,2022-08-15
728,134446,101402,86440,14962,17.3,2022-08-16
727,134446,101195,84518,16677,19.7,2022-08-17
726,134462,101828,83585,18243,21.8,2022-08-18
725,134462,100632,86684,13948,16.1,2022-08-19
724,134462,95284,76241,19043,25.0,2022-08-20
723,134462,96045,73895,22150,30.0,2022-08-21
722,134462,102558,86842,15716,18.1,2022-08-22
721,134462,101268,86792,14476,16.7,2022-08-23
720,134509,101820,79100,22720,28.7,2022-08-24
719,134509,102008,79448,22560,28.4,2022-08-25
718,134509,102136,77935,24201,31.1,2022-08-26
717,134509,97877,64721,33156,51.2,2022-08-27
716,134509,96902,64155,32747,51.0,2022-08-28
715,134509,98962,75328,23634,31.4,2022-08-29
714,134509,99404,77097,22307,28.9,2022-08-30
713,134695,99257,74990,24267,32.4,2022-08-31
712,134695,98608,78089,20519,26.3,2022-09-01
711,134695,99473,77142,22331,28.9,2022-09-02
710,134695,95712,67164,28548,42.5,2022-09-03
709,134695,97062,67901,29161,42.9,2022-09-04
708,134695,97945,79872,18073,22.6,2022-09-05
707,134695,97699,73602,24097,32.7,2022-09-06
706,134702,98348,73807,24541,33.3,2022-09-07
705,134702,95199,67681,27518,40.7,2022-09-08
704,134702,94422,57303,37119,64.8,2022-09-09
703,134702,93326,53936,39390,73.0,2022-09-10
702,134702,91779,57250,34529,60.3,2022-09-11
701,134702,91334,61790,29544,47.8,2022-09-12
700,134702,92082,75687,16395,21.7,2022-09-13
699,134702,93018,76406,16612,21.7,2022-09-14
698,134719,91430,79407,12023,15.1,2022-09-15
697,134719,91923,82122,9801,11.9,2022-09-16
696,134719,87077,71108,15969,22.5,2022-09-17
695,134719,89824,70720,19104,27.0,2022-09-18
694,134719,92433,78589,13844,17.6,2022-09-19
693,134719,88671,73548,15123,20.6,2022-09-20
692,134725,87357,72071,15286,21.2,2022-09-21
691,134725,87478,72184,15294,21.2,2022-09-22
690,134725,89172,70071,19101,27.3,2022-09-23
689,134725,87890,61033,26857,44.0,2022-09-24
688,134725,87931,59920,28011,46.7,2022-09-25
687,134725,89385,71400,17985,25.2,2022-09-26
686,134725,88928,72742,16186,22.3,2022-09-27
685,134725,88782,72806,15976,21.9,2022-09-28
684,134768,87139,73018,14121,19.3,2022-09-29
683,134768,88547,71844,16703,23.2,2022-09-30
682,134768,83632,61848,21784,35.2,2022-10-01
681,134768,84572,59834,24738,41.3,2022-10-02
680,134768,86928,66998,19930,29.7,2022-10-03
679,134768,86098,72544,13554,18.7,2022-10-04
678,134768,85928,70074,15854,22.6,2022-10-05
677,134797,86440,70544,15896,22.5,2022-10-06
676,134797,87225,68983,18242,26.4,2022-10-07
675,134797,85508,59871,25637,42.8,2022-10-08
674,134797,86454,58315,28139,48.3,2022-10-09
673,134797,84696,62700,21996,35.1,2022-10-10
672,134797,84595,70344,14251,20.3,2022-10-11
671,134797,83927,69872,14055,20.1,2022-10-12
670,134824,83262,70316,12946,18.4,2022-10-13
669,134824,82757,69004,13753,19.9,2022-10-14
668,134824,82961,60625,22336,36.8,2022-10-15
667,134824,84594,59248,25346,42.8,2022-10-16
666,134824,86767,70021,16746,23.9,2022-10-17
665,134824,86919,70701,16218,22.9,2022-10-18
664,134823,85998,70250,15748,22.4,2022-10-19
663,134823,84256,70976,13280,18.7,2022-10-20
662,134823,83851,69240,14611,21.1,2022-10-21
661,134823,80425,60433,19992,33.1,2022-10-22
660,134823,82226,58500,23726,40.6,2022-10-23
659,134823,83828,70139,13689,19.5,2022-10-24
658,134823,85434,70495,14939,21.2,2022-10-25
657,134823,84774,70052,14722,21.0,2022-10-26
656,134823,85104,70573,14531,20.6,2022-10-27
655,134823,84939,68956,15983,23.2,2022-10-28
654,134823,82677,59900,22777,38.0,2022-10-29
653,134823,83152,58605,24547,41.9,2022-10-30
652,136031,86565,69769,16796,24.1,2022-10-31
651,136031,82712,69729,12983,18.6,2022-11-01
650,136031,84799,69282,15517,22.4,2022-11-02
649,136031,84448,71242,13206,18.5,2022-11-03
648,136031,84682,70733,13949,19.7,2022-11-04
647,136031,84711,61328,23383,38.1,2022-11-05
646,136031,83073,59724,23349,39.1,2022-11-06
645,136031,85170,71020,14150,19.9,2022-11-07
644,136031,84526,69806,14720,21.1,2022-11-08
643,136200,83208,69966,13242,18.9,2022-11-09
642,136200,83233,69764,13469,19.3,2022-11-10
641,136200,82359,69415,12944,18.6,2022-11-11
640,136200,81862,60675,21187,34.9,2022-11-12
639,136200,83142,60054,23088,38.4,2022-11-13
638,136200,85353,71165,14188,19.9,2022-11-14
637,136200,86049,72431,13618,18.8,2022-11-15
636,136207,86564,71687,14877,20.8,2022-11-16
635,136207,85468,71642,13826,19.3,2022-11-17
634,136207,84158,70458,13700,19.4,2022-11-18
633,136207,83590,60856,22734,37.4,2022-11-19
632,136207,85105,60057,25048,41.7,2022-11-20
631,136207,86966,71811,15155,21.1,2022-11-21
630,136207,86178,74117,12061,16.3,2022-11-22
629,136249,85867,71774,14093,19.6,2022-11-23
628,136249,85945,72420,13525,18.7,2022-11-24
627,136249,87034,70886,16148,22.8,2022-11-25
626,136249,86934,61907,25027,40.4,2022-11-26
625,136249,87912,61147,26765,43.8,2022-11-27
624,136249,87897,74855,13042,17.4,2022-11-28
623,136249,91100,75720,15380,20.3,2022-11-29
622,136268,92682,82117,10565,12.9,2022-11-30
621,136268,96487,83052,13435,16.2,2022-12-01
620,136268,94957,80829,14128,17.5,2022-12-02
619,136268,92219,67989,24230,35.6,2022-12-03
618,136268,94440,67707,26733,39.5,2022-12-04
617,136268,96977,83990,12987,15.5,2022-12-05
616,136268,97332,84058,13274,15.8,2022-12-06
615,137861,96563,82135,14428,17.6,2022-12-07
614,137861,97385,81462,15923,19.5,2022-12-08
613,137861,97136,82223,14913,18.1,2022-12-09
612,137861,93012,67446,25566,37.9,2022-12-10
611,137861,96222,65907,30315,46.0,2022-12-11
610,137861,97985,83311,14674,17.6,2022-12-12
609,137861,98308,85195,13113,15.4,2022-12-13
608,137875,100637,90128,10509,11.7,2022-12-14
607,137875,102168,88874,13294,15.0,2022-12-15
606,137875,101510,89583,11927,13.3,2022-12-16
605,137875,101175,74303,26872,36.2,2022-12-17
604,137875,101564,73852,27712,37.5,2022-12-18
603,137875,103828,91710,12118,13.2,2022-12-19
602,137875,104369,90571,13798,15.2,2022-12-20
601,137938,103274,92698,10576,11.4,2022-12-21
600,137938,104749,92999,11750,12.6,2022-12-22
599,137938,105628,94509,11119,11.8,2022-12-23
598,137938,101805,75010,26795,35.7,2022-12-24
597,137938,103170,71213,31957,44.9,2022-12-25
596,137938,103765,89935,13830,15.4,2022-12-26
595,137938,105048,89282,15766,17.7,2022-12-27
594,138018,103841,88939,14902,16.8,2022-12-28
593,138018,103136,86768,16368,18.9,2022-12-29
592,138018,104511,83307,21204,25.5,2022-12-30
591,138018,102234,68466,33768,49.3,2022-12-31
590,138018,103636,66465,37171,55.9,2023-01-01
589,138018,104849,85269,19580,23.0,2023-01-02
588,138018,103751,87110,16641,19.1,2023-01-03
587,138193,105387,87191,18196,20.9,2023-01-04
586,138193,103422,89012,14410,16.2,2023-01-05
585,138193,100386,86606,13780,15.9,2023-01-06
584,138193,97543,70729,26814,37.9,2023-01-07
583,138193,98882,68090,30792,45.2,2023-01-08
582,138193,102864,84683,18181,21.5,2023-01-09
581,138193,103335,83973,19362,23.1,2023-01-10
580,138280,103840,83078,20762,25.0,2023-01-11
579,138280,105269,82287,22982,27.9,2023-01-12
578,138280,104134,81907,22227,27.1,2023-01-13
577,138280,102803,69388,33415,48.2,2023-01-14
576,138280,103949,69166,34783,50.3,2023-01-15
575,138280,106545,84582,21963,26.0,2023-01-16
574,138280,107179,86815,20364,23.5,2023-01-17
573,138399,104805,85627,19178,22.4,2023-01-18
572,138399,103674,84465,19209,22.7,2023-01-19
571,138399,105249,81244,24005,29.5,2023-01-20
570,138399,99057,68910,30147,43.7,2023-01-21
569,138399,98334,60143,38191,63.5,2023-01-22
568,138399,100500,62575,37925,60.6,2023-01-23
567,138399,101038,72643,28395,39.1,2023-01-24
566,138399,103636,87275,16361,18.7,2023-01-25
565,138399,103138,92613,10525,11.4,2023-01-26
564,138643,103908,89833,14075,15.7,2023-01-27
563,138643,98523,74081,24442,33.0,2023-01-28
562,138643,98222,69956,28266,40.4,2023-01-29
561,138643,101644,83568,18076,21.6,2023-01-30
560,138643,101699,84058,17641,21.0,2023-01-31
559,138647,102478,81652,20826,25.5,2023-02-01
558,138647,101827,83228,18599,22.3,2023-02-02
557,138647,101103,84290,16813,19.9,2023-02-03
556,138647,100826,70005,30821,44.0,2023-02-04
555,138647,100338,67195,33143,49.3,2023-02-05
554,138647,100804,81935,18869,23.0,2023-02-06
553,138647,97301,81585,15716,19.3,2023-02-07
552,138817,99128,81028,18100,22.3,2023-02-08
551,138817,99329,80850,18479,22.9,2023-02-09
550,138817,99009,81340,17669,21.7,2023-02-10
549,138817,97867,67796,30071,44.4,2023-02-11
548,138817,98838,65888,32950,50.0,2023-02-12
547,138817,99986,81235,18751,23.1,2023-02-13
546,138817,98967,79024,19943,25.2,2023-02-14
545,138840,99470,80643,18827,23.3,2023-02-15
544,138840,99109,81126,17983,22.2,2023-02-16
543,138840,98378,79701,18677,23.4,2023-02-17
542,138840,94387,68387,26000,38.0,2023-02-18
541,138840,97215,65618,31597,48.2,2023-02-19
540,138840,97609,78791,18818,23.9,2023-02-20
539,138840,97554,79297,18257,23.0,2023-02-21
538,138846,98864,78537,20327,25.9,2023-02-22
537,138846,99004,76790,22214,28.9,2023-02-23
536,138846,98287,76151,22136,29.1,2023-02-24
535,138846,96966,66816,30150,45.1,2023-02-25
534,138846,96610,64923,31687,48.8,2023-02-26
533,138846,95543,74630,20913,28.0,2023-02-27
532,138846,95866,74655,21211,28.4,2023-02-28
531,138846,92683,69174,23509,34.0,2023-03-01
530,138860,97952,76510,21442,28.0,2023-03-02
529,138860,98244,75363,22881,30.4,2023-03-03
528,138860,90987,64218,26769,41.7,2023-03-04
527,138860,87307,62329,24978,40.1,2023-03-05
526,138860,92749,72424,20325,28.1,2023-03-06
525,138860,93336,72608,20728,28.5,2023-03-07
524,138866,92310,70657,21653,30.6,2023-03-08
523,138866,92036,72032,20004,27.8,2023-03-09
522,138866,91060,68901,22159,32.2,2023-03-10
521,138866,84465,60181,24284,40.4,2023-03-11
520,138866,85088,62216,22872,36.8,2023-03-12
519,138866,90608,72805,17803,24.5,2023-03-13
518,138866,89931,70755,19176,27.1,2023-03-14
517,139011,88788,70533,18255,25.9,2023-03-15
516,139011,88531,72068,16463,22.8,2023-03-16
515,139011,89299,71612,17687,24.7,2023-03-17
514,139011,86856,61605,25251,41.0,2023-03-18
513,139011,84692,60568,24124,39.8,2023-03-19
512,139011,83818,69333,14485,20.9,2023-03-20
511,139011,87042,68985,18057,26.2,2023-03-21
510,139025,85956,68792,17164,25.0,2023-03-22
509,139025,85967,71388,14579,20.4,2023-03-23
508,139025,88027,68133,19894,29.2,2023-03-24
507,139025,82416,60553,21863,36.1,2023-03-25
506,139025,83053,59275,23778,40.1,2023-03-26
505,139025,88424,69047,19377,28.1,2023-03-27
504,139025,86976,69012,17964,26.0,2023-03-28
503,139049,87768,68140,19628,28.8,2023-03-29
502,139049,86801,67833,18968,28.0,2023-03-30
501,139049,85199,65629,19570,29.8,2023-03-31
500,139049,81707,59002,22705,38.5,2023-04-01
499,139049,81707,59002,22705,38.5,2023-04-01
498,139049,85228,58205,27023,46.4,2023-04-02
497,139049,85228,58205,27023,46.4,2023-04-02
495,139049,84289,67649,16640,24.6,2023-04-03
496,139049,84289,67649,16640,24.6,2023-04-03
493,139049,84938,68535,16403,23.9,2023-04-04
494,139049,84938,68535,16403,23.9,2023-04-04
492,139079,84179,72292,11887,16.4,2023-04-05
491,139079,84179,72292,11887,16.4,2023-04-05
490,139079,84070,70688,13382,18.9,2023-04-06
489,139079,84070,70688,13382,18.9,2023-04-06
488,139079,85615,66780,18835,28.2,2023-04-07
487,139079,85615,66780,18835,28.2,2023-04-07
486,139079,84600,59967,24633,41.1,2023-04-08
485,139079,84600,59967,24633,41.1,2023-04-08
483,139079,83956,58648,25308,43.2,2023-04-09
484,139079,83956,58648,25308,43.2,2023-04-09
481,139079,83951,67150,16801,25.0,2023-04-10
482,139079,83951,67150,16801,25.0,2023-04-10
480,139079,83307,69385,13922,20.1,2023-04-11
479,139048,83551,67710,15841,23.4,2023-04-12
478,139048,82778,67686,15092,22.3,2023-04-13
477,139048,82131,67403,14728,21.9,2023-04-14
476,139048,79939,59880,20059,33.5,2023-04-15
475,139048,81738,58530,23208,39.7,2023-04-16
474,139048,82728,67016,15712,23.4,2023-04-17
473,139048,82167,71402,10765,15.1,2023-04-18
472,139100,84523,67904,16619,24.5,2023-04-19
471,139100,84194,69019,15175,22.0,2023-04-20
470,139100,84862,65953,18909,28.7,2023-04-21
469,139100,81689,58620,23069,39.4,2023-04-22
468,139100,81460,57975,23485,40.5,2023-04-23
467,139100,80652,66664,13988,21.0,2023-04-24
466,139100,82630,69358,13272,19.1,2023-04-25
465,139065,82164,66959,15205,22.7,2023-04-26
464,139065,80656,66708,13948,20.9,2023-04-27
463,139065,81098,65812,15286,23.2,2023-04-28
462,139065,80693,59105,21588,36.5,2023-04-29
461,139065,78787,56344,22443,39.8,2023-04-30
460,139065,84199,58849,25350,43.1,2023-05-01
459,139065,83580,66341,17239,26.0,2023-05-02
458,139065,84319,66914,17405,26.0,2023-05-03
457,139065,85400,66972,18428,27.5,2023-05-04
456,139065,82783,61504,21279,34.6,2023-05-05
455,139065,81015,57640,23375,40.6,2023-05-06
454,139065,82320,57038,25282,44.3,2023-05-07
453,139065,82152,65456,16696,25.5,2023-05-08
452,139065,82009,66833,15176,22.7,2023-05-09
451,139147,82235,66339,15896,24.0,2023-05-10
450,139147,83347,67295,16052,23.9,2023-05-11
449,139147,82904,65469,17435,26.6,2023-05-12
448,139147,82692,59028,23664,40.1,2023-05-13
447,139147,82371,58026,24345,42.0,2023-05-14
446,139147,82771,67563,15208,22.5,2023-05-15
445,139147,81823,69942,11881,17.0,2023-05-16
444,139171,81136,69974,11162,16.0,2023-05-17
443,139171,84042,70912,13130,18.5,2023-05-18
442,139171,82309,67914,14395,21.2,2023-05-19
441,140240,81884,60092,21792,36.3,2023-05-20
440,140240,83862,58588,25274,43.1,2023-05-21
439,140240,82998,67579,15419,22.8,2023-05-22
438,140240,82407,67974,14433,21.2,2023-05-23
437,140240,81333,67877,13456,19.8,2023-05-24
436,140240,83621,68519,15102,22.0,2023-05-25
435,140240,84268,68018,16250,23.9,2023-05-26
434,140240,82676,60765,21911,36.1,2023-05-27
433,140240,79202,59003,20199,34.2,2023-05-28
432,140240,79383,65013,14370,22.1,2023-05-29
431,140240,82332,72772,9560,13.1,2023-05-30
430,140240,83165,69289,13876,20.0,2023-05-31
429,140758,83644,71202,12442,17.5,2023-06-01
428,140758,82669,68262,14407,21.1,2023-06-02
427,140758,82672,59502,23170,38.9,2023-06-03
426,140758,84682,59372,25310,42.6,2023-06-04
425,140758,84710,65659,19051,29.0,2023-06-05
424,140758,86513,63781,22732,35.6,2023-06-06
423,140758,85092,69540,15552,22.4,2023-06-07
422,140758,85279,70755,14524,20.5,2023-06-08
421,140758,83619,69747,13872,19.9,2023-06-09
420,140758,82997,61953,21044,34.0,2023-06-10
419,140758,82473,62339,20134,32.3,2023-06-11
418,140758,87631,71512,16119,22.5,2023-06-12
417,140758,86678,72258,14420,20.0,2023-06-13
416,140908,86792,71475,15317,21.4,2023-06-14
415,140908,84221,72139,12082,16.7,2023-06-15
414,140908,85483,72163,13320,18.5,2023-06-16
413,140908,83897,63664,20233,31.8,2023-06-17
412,140908,84025,64094,19931,31.1,2023-06-18
411,140908,91145,79351,11794,14.9,2023-06-19
410,140908,91012,76566,14446,18.9,2023-06-20
409,140945,90548,75890,14658,19.3,2023-06-21
408,140945,90532,73402,17130,23.3,2023-06-22
407,140945,90105,73677,16428,22.3,2023-06-23
406,140945,88311,66496,21815,32.8,2023-06-24
405,140945,86380,66484,19896,29.9,2023-06-25
404,140945,93188,79558,13630,17.1,2023-06-26
403,140945,93711,77801,15910,20.4,2023-06-27
402,140945,94576,79205,15371,19.4,2023-06-28
401,140955,93562,82196,11366,13.8,2023-06-29
400,140955,93460,79294,14166,17.9,2023-06-30
399,140955,95423,69581,25842,37.1,2023-07-01
398,140955,95689,69809,25880,37.1,2023-07-02
397,140955,98483,84023,14460,17.2,2023-07-03
396,140955,97789,83089,14700,17.7,2023-07-04
395,141984,98922,77283,21639,28.0,2023-07-05
394,141984,99885,82268,17617,21.4,2023-07-06
393,141984,96783,82068,14715,17.9,2023-07-07
392,141984,94216,69633,24583,35.3,2023-07-08
391,141984,95134,68423,26711,39.0,2023-07-09
390,141984,99558,82203,17355,21.1,2023-07-10
389,141984,98896,83533,15363,18.4,2023-07-11
388,142126,99381,82046,17335,21.1,2023-07-12
387,142126,98496,84575,13921,16.5,2023-07-13
386,142126,98278,84380,13898,16.5,2023-07-14
385,142126,94588,70903,23685,33.4,2023-07-15
384,142126,95585,68041,27544,40.5,2023-07-16
383,142126,102562,82555,20007,24.2,2023-07-17
382,142126,101987,82615,19372,23.4,2023-07-18
381,142201,103424,80874,22550,27.9,2023-07-19
380,142201,104568,83731,20837,24.9,2023-07-20
379,142201,103301,84221,19080,22.7,2023-07-21
378,142201,99735,72220,27515,38.1,2023-07-22
377,142201,99820,70370,29450,41.9,2023-07-23
376,142201,102648,83062,19586,23.6,2023-07-24
375,142201,103526,83943,19583,23.3,2023-07-25
374,142201,103142,86054,17088,19.9,2023-07-26
373,142201,102234,87033,15201,17.5,2023-07-27
372,142567,102152,85321,16831,19.7,2023-07-28
371,142567,99446,76405,23041,30.2,2023-07-29
370,142567,100571,74605,25966,34.8,2023-07-30
369,142567,101789,80734,21055,26.1,2023-07-31
368,142567,101734,82962,18772,22.6,2023-08-01
367,142567,102567,82699,19868,24.0,2023-08-02
366,142567,101997,85990,16007,18.6,2023-08-03
365,142567,101133,86089,15044,17.5,2023-08-04
364,142567,101731,80221,21510,26.8,2023-08-05
363,142567,101793,79971,21822,27.3,2023-08-06
362,142567,104297,93615,10682,11.4,2023-08-07
361,142567,103860,93299,10561,11.3,2023-08-08
360,142584,103773,89935,13838,15.4,2023-08-09
359,142584,102841,81651,21190,26.0,2023-08-10
358,142584,103881,80549,23332,29.0,2023-08-11
357,142584,99351,69688,29663,42.6,2023-08-12
356,142584,99087,72148,26939,37.3,2023-08-13
355,142584,102576,82760,19816,23.9,2023-08-14
354,142584,102421,80630,21791,27.0,2023-08-15
353,142584,102713,86140,16573,19.2,2023-08-16
352,142584,102798,86794,16004,18.4,2023-08-17
351,142584,102810,88570,14240,16.1,2023-08-18
350,142584,101346,77513,23833,30.7,2023-08-19
349,143332,100227,76867,23360,30.4,2023-08-20
348,143332,102587,91334,11253,12.3,2023-08-21
347,143332,104034,90322,13712,15.2,2023-08-22
346,143332,103456,87971,15485,17.6,2023-08-23
345,143332,102384,86561,15823,18.3,2023-08-24
344,143332,102355,82632,19723,23.9,2023-08-25
343,143332,98457,71966,26491,36.8,2023-08-26
342,143332,96857,71334,25523,35.8,2023-08-27
341,143332,102236,81578,20658,25.3,2023-08-28
340,143332,102207,83947,18260,21.8,2023-08-29
339,143401,101752,81190,20562,25.3,2023-08-30
338,143401,101698,77880,23818,30.6,2023-08-31
337,143401,100172,76397,23775,31.1,2023-09-01
336,143401,97506,68954,28552,41.4,2023-09-02
335,143401,98099,70303,27796,39.5,2023-09-03
334,143401,99186,85567,13619,15.9,2023-09-04
333,143401,99391,85682,13709,16.0,2023-09-05
332,143429,98686,84181,14505,17.2,2023-09-06
331,143429,98334,81665,16669,20.4,2023-09-07
330,143429,98050,78754,19296,24.5,2023-09-08
329,143429,94923,69152,25771,37.3,2023-09-09
328,143429,95818,68207,27611,40.5,2023-09-10
327,143429,97469,81913,15556,19.0,2023-09-11
326,143429,96217,82478,13739,16.7,2023-09-12
325,143460,94349,81364,12985,16.0,2023-09-13
324,143460,94930,80149,14781,18.4,2023-09-14
323,143460,94430,78139,16291,20.8,2023-09-15
322,143460,89463,69043,20420,29.6,2023-09-16
321,143460,92366,67762,24604,36.3,2023-09-17
320,143460,94611,79866,14745,18.5,2023-09-18
319,143460,91780,79704,12076,15.2,2023-09-19
318,143481,91763,79940,11823,14.8,2023-09-20
317,143481,92647,74465,18182,24.4,2023-09-21
316,143481,92123,71935,20188,28.1,2023-09-22
315,143481,88758,63395,25363,40.0,2023-09-23
314,143481,87899,61853,26046,42.1,2023-09-24
313,143481,90962,74249,16713,22.5,2023-09-25
312,143481,89883,74562,15321,20.5,2023-09-26
311,143486,91105,71537,19568,27.4,2023-09-27
310,143486,92297,56740,35557,62.7,2023-09-28
309,143486,89759,52425,37334,71.2,2023-09-29
308,143486,87107,54122,32985,60.9,2023-09-30
307,143486,88085,54323,33762,62.2,2023-10-01
306,143486,89665,57484,32181,56.0,2023-10-02
305,143486,88991,61368,27623,45.0,2023-10-03
304,143486,87361,70315,17046,24.2,2023-10-04
303,143486,88648,68749,19899,28.9,2023-10-05
302,143486,89340,68442,20898,30.5,2023-10-06
301,143486,88103,60894,27209,44.7,2023-10-07
300,143486,87772,58651,29121,49.7,2023-10-08
299,143486,86123,63732,22391,35.1,2023-10-09
298,143486,85494,70604,14890,21.1,2023-10-10
297,143486,84960,70443,14517,20.6,2023-10-11
296,143559,84165,70840,13325,18.8,2023-10-12
295,143559,84971,69448,15523,22.4,2023-10-13
294,143559,82270,60838,21432,35.2,2023-10-14
293,143559,83060,59651,23409,39.2,2023-10-15
292,143559,85263,69274,15989,23.1,2023-10-16
291,143559,84574,69960,14614,20.9,2023-10-17
290,143712,86240,69700,16540,23.7,2023-10-18
289,143712,85738,70985,14753,20.8,2023-10-19
288,143712,87249,67722,19527,28.8,2023-10-20
287,143712,83506,59888,23618,39.4,2023-10-21
286,143712,85357,58718,26639,45.4,2023-10-22
285,143712,83397,69638,13759,19.8,2023-10-23
284,143712,84248,70197,14051,20.0,2023-10-24
283,143731,83979,69653,14326,20.6,2023-10-25
282,143731,83740,70646,13094,18.5,2023-10-26
281,143731,84240,68296,15944,23.3,2023-10-27
280,143731,81318,59753,21565,36.1,2023-10-28
279,143731,82674,58684,23990,40.9,2023-10-29
278,143731,82961,69602,13359,19.2,2023-10-30
277,143731,84749,69878,14871,21.3,2023-10-31
276,143770,84681,69845,14836,21.2,2023-11-01
275,143770,86411,70489,15922,22.6,2023-11-02
274,143770,86921,69323,17598,25.4,2023-11-03
273,143770,86600,61037,25563,41.9,2023-11-04
272,143770,84474,60309,24165,40.1,2023-11-05
271,143770,85794,69757,16037,23.0,2023-11-06
270,143770,88748,70456,18292,26.0,2023-11-07
269,143802,88768,68456,20312,29.7,2023-11-08
268,143802,88466,69833,18633,26.7,2023-11-09
267,143802,90043,70206,19837,28.3,2023-11-10
266,143802,90025,63124,26901,42.6,2023-11-11
265,143802,90094,63156,26938,42.7,2023-11-12
264,143802,90613,75186,15427,20.5,2023-11-13
263,143802,89441,74305,15136,20.4,2023-11-14
262,143978,89641,73401,16240,22.1,2023-11-15
261,143978,89652,78815,10837,13.7,2023-11-16
260,143978,90313,76618,13695,17.9,2023-11-17
259,143978,91879,66148,25731,38.9,2023-11-18
258,143978,91299,62598,28701,45.8,2023-11-19
257,143978,92492,75162,17330,23.1,2023-11-20
256,143978,91666,74025,17641,23.8,2023-11-21
255,144336,92695,73266,19429,26.5,2023-11-22
254,144336,92817,72557,20260,27.9,2023-11-23
253,144336,97329,76598,20731,27.1,2023-11-24
252,144336,91812,66540,25272,38.0,2023-11-25
251,144336,90868,63720,27148,42.6,2023-11-26
250,144026,93206,79861,13345,16.7,2023-11-27
249,144026,96172,78894,17278,21.9,2023-11-28
248,144063,96664,81146,15518,19.1,2023-11-29
247,144063,96366,82716,13650,16.5,2023-11-30
246,144063,99572,81228,18344,22.6,2023-12-01
245,144063,96616,66924,29692,44.4,2023-12-02
244,144063,97827,65368,32459,49.7,2023-12-03
243,144063,99020,79599,19421,24.4,2023-12-04
242,144063,97325,78441,18884,24.1,2023-12-05
241,144070,99399,79102,20297,25.7,2023-12-06
240,144070,100157,77237,22920,29.7,2023-12-07
239,144070,99956,75245,24711,32.8,2023-12-08
238,144070,97556,62483,35073,56.1,2023-12-09
237,144070,96107,61067,35040,57.4,2023-12-10
236,144070,100669,76893,23776,30.9,2023-12-11
235,144070,100804,76995,23809,30.9,2023-12-12
234,144200,101145,75581,25564,33.8,2023-12-13
233,144200,101310,77896,23414,30.1,2023-12-14
232,144200,99963,78513,21450,27.3,2023-12-15
231,144200,99891,70383,29508,41.9,2023-12-16
230,144200,99119,70703,28416,40.2,2023-12-17
229,144200,103366,88869,14497,16.3,2023-12-18
228,144200,101928,88580,13348,15.1,2023-12-19
227,144381,103834,89230,14604,16.4,2023-12-20
226,144381,105213,91556,13657,14.9,2023-12-21
225,144381,104466,91391,13075,14.3,2023-12-22
224,144381,103207,73369,29838,40.7,2023-12-23
223,144381,102110,68643,33467,48.8,2023-12-24
222,144381,103217,71050,32167,45.3,2023-12-25
221,144381,102816,84106,18710,22.2,2023-12-26
220,144381,103064,82383,20681,25.1,2023-12-27
219,144381,102810,81745,21065,25.8,2023-12-28
218,144415,103693,78244,25449,32.5,2023-12-29
217,144415,102366,66025,36341,55.0,2023-12-30
216,144415,102709,63589,39120,61.5,2023-12-31
215,144415,101990,63132,38858,61.6,2024-01-01
214,144415,103419,80460,22959,28.5,2024-01-02
213,144415,101197,83422,17775,21.3,2024-01-03
212,144421,101701,81728,19973,24.4,2024-01-04
211,144421,101519,80632,20887,25.9,2024-01-05
210,144421,99930,67965,31965,47.0,2024-01-06
209,144421,103720,69798,33922,48.6,2024-01-07
208,144421,105598,84150,21448,25.5,2024-01-08
207,144421,103910,88214,15696,17.8,2024-01-09
206,144426,105583,85081,20502,24.1,2024-01-10
205,144426,103418,84185,19233,22.8,2024-01-11
204,144426,102931,80506,22425,27.9,2024-01-12
203,144426,98104,68211,29893,43.8,2024-01-13
202,144426,102984,66854,36130,54.0,2024-01-14
201,144426,105880,81436,24444,30.0,2024-01-15
200,144426,104133,83487,20646,24.7,2024-01-16
199,144640,103539,86162,17377,20.2,2024-01-17
198,144640,102314,82978,19336,23.3,2024-01-18
197,144640,101298,81003,20295,25.1,2024-01-19
196,144640,97708,69500,28208,40.6,2024-01-20
195,144640,99278,66867,32411,48.5,2024-01-21
194,144640,104312,86746,17566,20.2,2024-01-22
193,144640,104997,89231,15766,17.7,2024-01-23
192,144652,104666,88055,16611,18.9,2024-01-24
191,144652,104370,86788,17582,20.3,2024-01-25
190,144652,102593,84354,18239,21.6,2024-01-26
189,144652,100226,69125,31101,45.0,2024-01-27
188,144652,100740,67741,32999,48.7,2024-01-28
187,144652,101454,82039,19415,23.7,2024-01-29
186,144652,100814,82692,18122,21.9,2024-01-30
185,144746,99286,80671,18615,23.1,2024-01-31
184,144746,97420,81677,15743,19.3,2024-02-01
183,144746,99377,79921,19456,24.3,2024-02-02
182,144746,96458,66832,29626,44.3,2024-02-03
181,144746,98483,64807,33676,52.0,2024-02-04
180,144746,97905,82573,15332,18.6,2024-02-05
179,144746,97363,83641,13722,16.4,2024-02-06
178,144765,97216,79115,18101,22.9,2024-02-07
177,144765,101029,77521,23508,30.3,2024-02-08
176,144765,98759,62755,36004,57.4,2024-02-09
175,144765,98681,57179,41502,72.6,2024-02-10
174,144765,100590,58509,42081,71.9,2024-02-11
173,144765,98537,61340,37197,60.6,2024-02-12
172,144765,99200,71718,27482,38.3,2024-02-13
171,144765,99406,75951,23455,30.9,2024-02-14
170,144779,99252,78957,20295,25.7,2024-02-15
169,144779,98981,75965,23016,30.3,2024-02-16
168,144779,99297,64340,34957,54.3,2024-02-17
167,144779,98249,63128,35121,55.6,2024-02-18
166,144779,100165,76849,23316,30.3,2024-02-19
165,144779,100078,79989,20089,25.1,2024-02-20
164,144983,101952,81790,20162,24.7,2024-02-21
163,144983,101921,84093,17828,21.2,2024-02-22
162,144983,102637,81368,21269,26.1,2024-02-23
161,144983,99383,66189,33194,50.2,2024-02-24
160,144983,99547,63998,35549,55.5,2024-02-25
159,144983,97595,74935,22660,30.2,2024-02-26
158,144983,99023,75933,23090,30.4,2024-02-27
157,145013,98589,74394,24195,32.5,2024-02-28
156,145013,98139,79171,18968,24.0,2024-02-29
155,145013,98086,70870,27216,38.4,2024-03-01
154,145013,97767,66510,31257,47.0,2024-03-02
153,145013,94824,64502,30322,47.0,2024-03-03
152,145013,97561,76456,21105,27.6,2024-03-04
151,145013,95500,81691,13809,16.9,2024-03-05
150,145016,94421,75397,19024,25.2,2024-03-06
149,145016,94616,77363,17253,22.3,2024-03-07
148,145016,94887,74464,20423,27.4,2024-03-08
147,145016,86562,65322,21240,32.5,2024-03-09
146,145016,85565,63464,22101,34.8,2024-03-10
145,145016,92202,74908,17294,23.1,2024-03-11
144,145016,91404,78213,13191,16.9,2024-03-12
143,145008,87647,73868,13779,18.7,2024-03-13
142,145008,89106,73172,15934,21.8,2024-03-14
141,145008,89233,70500,18733,26.6,2024-03-15
140,145008,83600,62121,21479,34.6,2024-03-16
139,145008,82789,61659,21130,34.3,2024-03-17
138,145008,88397,71342,17055,23.9,2024-03-18
137,145008,88935,73424,15511,21.1,2024-03-19
136,145162,87216,72438,14778,20.4,2024-03-20
135,145162,87429,72439,14990,20.7,2024-03-21
134,145162,84736,70498,14238,20.2,2024-03-22
133,145162,82122,60972,21150,34.7,2024-03-23
132,145162,81739,59839,21900,36.6,2024-03-24
131,145162,86170,72997,13173,18.0,2024-03-25
130,145162,87608,74182,13426,18.1,2024-03-26
129,145175,87771,69829,17942,25.7,2024-03-27
128,145175,86289,75842,10447,13.8,2024-03-28
127,145175,88279,69967,18312,26.2,2024-03-29
126,145175,83827,60199,23628,39.2,2024-03-30
125,145175,80988,58369,22619,38.8,2024-03-31
124,145175,86473,67349,19124,28.4,2024-04-01
123,145175,85029,67742,17287,25.5,2024-04-02
122,145191,83155,71199,11956,16.8,2024-04-03
121,145191,84160,68151,16009,23.5,2024-04-04
120,146634,87037,65933,21104,32.0,2024-04-05
119,146634,85887,58937,26950,45.7,2024-04-06
118,146634,85279,57502,27777,48.3,2024-04-07
117,146634,86350,67383,18967,28.1,2024-04-08
116,146634,89521,66950,22571,33.7,2024-04-09
115,146634,89416,62161,27255,43.8,2024-04-10
114,146634,87821,66663,21158,31.7,2024-04-11
113,146634,87005,64816,22189,34.2,2024-04-12
112,146634,84897,58314,26583,45.6,2024-04-13
111,146634,84810,58115,26695,45.9,2024-04-14
110,146634,86527,68634,17893,26.1,2024-04-15
109,146634,86462,67321,19141,28.4,2024-04-16
108,146648,86950,66182,20768,31.4,2024-04-17
107,146648,86846,66740,20106,30.1,2024-04-18
106,146648,85986,65136,20850,32.0,2024-04-19
105,146648,81025,59338,21687,36.5,2024-04-20
104,146648,80579,58279,22300,38.3,2024-04-21
103,146648,81352,66727,14625,21.9,2024-04-22
102,146648,83431,66991,16440,24.5,2024-04-23
101,146804,84100,66215,17885,27.0,2024-04-24
100,146804,84577,66552,18025,27.1,2024-04-25
99,146804,82938,65026,17912,27.5,2024-04-26
98,146804,82586,57999,24587,42.4,2024-04-27
97,146804,82956,58003,24953,43.0,2024-04-28
96,146804,82388,67228,15160,22.6,2024-04-29
95,146804,84692,66065,18627,28.2,2024-04-30
94,146769,84183,60711,23472,38.7,2024-05-01
93,146769,85106,66858,18248,27.3,2024-05-02
92,146769,83940,65403,18537,28.3,2024-05-03
91,146769,80783,57871,22912,39.6,2024-05-04
90,146769,79862,57151,22711,39.7,2024-05-05
89,146769,79868,60134,19734,32.8,2024-05-06
88,146769,82553,67765,14788,21.8,2024-05-07
87,146769,83781,65047,18734,28.8,2024-05-08
86,146781,84188,66481,17707,26.6,2024-05-09
85,146781,84637,65342,19295,29.5,2024-05-10
84,146781,81666,60042,21624,36.0,2024-05-11
83,146781,83874,57019,26855,47.1,2024-05-12
82,146781,82781,66062,16719,25.3,2024-05-13
81,146781,82838,66155,16683,25.2,2024-05-14
80,146781,84159,61854,22305,36.1,2024-05-15
79,146781,84251,65411,18840,28.8,2024-05-16
78,147824,84810,64407,20403,31.7,2024-05-17
77,147824,80001,58755,21246,36.2,2024-05-18
76,147824,81405,58903,22502,38.2,2024-05-19
75,147824,81523,68764,12759,18.6,2024-05-20
74,147824,81608,69074,12534,18.1,2024-05-21
73,147999,82015,68837,13178,19.1,2024-05-22
72,147999,82585,69899,12686,18.1,2024-05-23
71,147999,83976,67481,16495,24.4,2024-05-24
70,147999,81428,59700,21728,36.4,2024-05-25
69,147999,81935,59436,22499,37.9,2024-05-26
68,147999,81417,67126,14291,21.3,2024-05-27
67,147999,80711,68694,12017,17.5,2024-05-28
66,148010,81388,68823,12565,18.3,2024-05-29
65,148010,81392,69571,11821,17.0,2024-05-30
64,148010,81185,66428,14757,22.2,2024-05-31
63,148010,80669,59085,21584,36.5,2024-06-01
62,148010,80914,58661,22253,37.9,2024-06-02
61,148010,83320,68493,14827,21.6,2024-06-03
60,148010,82534,69279,13255,19.1,2024-06-04
59,148013,82374,69421,12953,18.7,2024-06-05
58,148013,82299,65329,16970,26.0,2024-06-06
57,148013,81430,67558,13872,20.5,2024-06-07
56,148013,78011,60509,17502,28.9,2024-06-08
55,148013,80290,60934,19356,31.8,2024-06-09
54,148013,83154,72134,11020,15.3,2024-06-10
53,148013,85597,74244,11353,15.3,2024-06-11
52,148084,84347,74251,10096,13.6,2024-06-12
51,148084,85470,76144,9326,12.2,2024-06-13
50,148084,86901,75619,11282,14.9,2024-06-14
49,148084,83230,66114,17116,25.9,2024-06-15
48,148084,81459,63577,17882,28.1,2024-06-16
47,148084,86828,73958,12870,17.4,2024-06-17
46,148084,87447,76826,10621,13.8,2024-06-18
45,148089,89170,80077,9093,11.4,2024-06-19
44,148089,89378,79731,9647,12.1,2024-06-20
43,148089,91016,77749,13267,17.1,2024-06-21
42,148089,84914,68355,16559,24.2,2024-06-22
41,148089,86778,66868,19910,29.8,2024-06-23
40,148089,91515,76628,14887,19.4,2024-06-24
39,148089,91673,73022,18651,25.5,2024-06-25
38,148089,93282,74719,18563,24.8,2024-06-26
37,148089,92041,76144,15897,20.9,2024-06-27
36,148089,89229,74741,14488,19.4,2024-06-28
35,148089,88692,68360,20332,29.7,2024-06-29
34,148709,92841,65856,26985,41.0,2024-06-30
33,148709,95058,78373,16685,21.3,2024-07-01
32,148709,95711,79801,15910,19.9,2024-07-02
31,148897,95509,77555,17954,23.2,2024-07-03
30,148897,95812,81970,13842,16.9,2024-07-04
29,148897,95500,77102,18398,23.9,2024-07-05
28,148897,93120,72015,21105,29.3,2024-07-06
27,148897,93120,70129,22991,32.8,2024-07-07
26,148897,96391,83021,13370,16.1,2024-07-08
25,148897,97233,82246,14987,18.2,2024-07-09
24,148912,97872,80964,16908,20.9,2024-07-10
23,148912,98172,79983,18189,22.7,2024-07-11
22,148912,97623,78463,19160,24.4,2024-07-12
21,148912,96929,71353,25576,35.8,2024-07-13
20,148912,95453,69336,26117,37.7,2024-07-14
19,148912,100094,82759,17335,20.9,2024-07-15
18,148912,98716,83678,15038,18.0,2024-07-16
17,148917,99597,84204,15393,18.3,2024-07-17
16,148917,98615,84567,14048,16.6,2024-07-18
15,148917,96173,82174,13999,17.0,2024-07-19
14,148917,98911,74657,24254,32.5,2024-07-20
13,148917,98147,74740,23407,31.3,2024-07-21
12,148917,100373,86921,13452,15.5,2024-07-22
11,148917,99079,87645,11434,13.0,2024-07-23
10,148932,100266,87552,12714,14.5,2024-07-24
9,148932,99162,90254,8908,9.9,2024-07-25
8,148932,99785,88660,11125,12.5,2024-07-26
7,148932,94695,77483,17212,22.2,2024-07-27
6,148932,95923,76431,19492,25.5,2024-07-28
5,148932,96042,82616,13426,16.3,2024-07-29
4,148932,96704,84530,12174,14.4,2024-07-30
3,149151,96018,84794,11224,13.2,2024-07-31
2,149151,96211,85215,10996,12.9,2024-08-01
1,149151,99899,85301,14598,17.1,2024-08-02
0,149151,96672,80942,15730,19.4,2024-08-03
